http://www.yso.fi/onto/yso/p6421 oopperat (teokset)
oopperat (teokset) oopperat
Pula!-ooppera levytetään kesällä
Häkki heilahtaa Schroderukselle : Opera på Skäret -festivaalilla esitetään Puccinin Toscaa
Oopperan vahvat naiset : Uniikkikorsetit
Sevillan parturi
Pula!-kuume nousee kovaa
Hui kauhistus! : Yksinäytöksinen ooppera
Vaikutelma kukkasesta : kerroksellinen punainen puku tahtoo korostaa Mimin eli Helena Juntusen aistillisuutta
Vanhat eväät, maku tuore : Helena Juntunen tuo La Bohémeen maailmanluokan herkkyyttä ja taitoa ; oopperan ensi-ilta
Onnistunut debyytti Italiassa : Helena Juntunen toi näyttämöllistä ilmaisua Matka Reimsiin -oopperaan
Klassikko hyvissä käsissä
Intohimoinen taiteen ohjaaja : viikon profiili
Joaquín Murietan sankaruus ja kuolema = Fulgor y muerte de Joaquín Murieta /.
Äänifakista toiseen : äänityypit ja äänifakin vaihtaminen lyyrisellä ja dramaattisella naisäänellä
Pohjalaisia on vuoden suosikkiooppera : Leevi Madetojan täysosumateos näyttämölle Kansallisoopperassa ja Ilmajoen musiikkijuhlilla
Oululainen ooppera teatterin vastuulle : johtajuuden puutetta paikataan päätöksentekoa keskittämällä
Parsifal : Ein Bühnenweihfestpiel : 3-näytöksinen musiikkidraama
Otello : dramma lirico in quattro atti = nelinäytöksinen ooppera
Taru rakkaudesta : Dido ja Aeneas : kolminäytöksinen ooppera
F1-Garon kesähäät Öjassa : Leea Klemola, Kokkolan ooppera ja Figaron häiden pervoutusoperaatio
Sopraano saa virtaa kotiseudulta : Helena Juntunen laulaa Mozartin Requiemissa ja valmistautuu Cardiffin kilpailuun
Ritari herää Ruususen unestaan
Joutilas mies soi neljästi ensi kesänä : jäähalli taipuu taas oopperan näyttämöksi ja katsomoksi
Yhteisoopperat tauolla : Opperayhdistys ja teatteriyhtiö eivät ole vielä löytäneet toisiaan
Pula-oopperan kipinä lensi Muoniosta : Nivalan Pula-oopperassa nähdään ensi kesänä suomalaisia maailmantähtiä
Caruso : rikosromaani
Ooppera paikallisten kykyjen voimin : Raahen musiikkiopisto tarjoaa suussa sulavaa barokkimusiikkia
Ikuinen rakkaus, petos ja kuolema : visuaalinen Naamiohuvit kertaa tuttuja teemoja
Jevgeni Onegin : 3-näytöksinen ooppera
Pula! -päällikkö myrskyn silmässä
Tuottaja luottaa tiimiinsä täydellisesti
Peruselementit vahvasti esillä : Orfeus ja Eurydike -oopperan puvustus ja lavastus näyttävät vähässä paljon
Lohengrin : Oper in drei Aufzügen = kolminäytöksinen ooppera
Fantasiaa ja kauhua oopperassa : Oulun kaupungiteatterissa alkavat pian kummitella Hoffmannin kertomukset
Aïno Ackté : kansainvälinen primadonna
Mtsenskin kihlakunnan Lady Macbeth eli Katerina Ismailova
Parsifal : Ein Bühnenfestspiel in drei Aufzügen = kolminäytöksinen uskonnollinen juhlanäytelmä
Il barbiere di Siviglia = Sevillan parturi : melodramma buffo in due atti : kaksinäytöksinen ooppera
Hannu ja Kerttu viittomakielelle : valmistautuminen satuoopperan tulkkaukseen
Ja aamulla Hoffmannin päätä särkee
Ansiokas tutkimus Kaija Saariahon Kaukainen rakkaus -oopperasta
Rigoletto : Melodramma in tre atti = Kolminäytöksinen ooppera
"Uupperoita"
Neljän elämän risteys kääntyy oopperaksi : Oulun kaupunginteatteri juhlistaa 100-vuotiasta Suomea Tapio Tuomelan uuden oopperan kantaesityksellä tammikuussa 2017.
Helena kipuaa Liuksi : Puccinin Turandot on Savonlinnan uutuusteos
Boris Godunov : Säveldraama 4:nä näytöksenä proloogineen (9 kuvaelmaa) : Pushkinin ja Karamtsinin mukaan
Oopperaroolin työstäminen produktiossa Henry Purcellin Dido ja Aeneas
Jokilaaksojen oopperalla olisi vientiä : perusteilla oleva säätiö saanut yhteistyötarjouksen USA:sta
Arabella : lyrische Komödie in drei Aufzügen = kolminäytöksinen lyyrinen komedia
Rockland-oopperan taltiointi : Teräväpiirtokuvausten suunnittelu ja toteutus
Oululle tarjotaan oopperayhteistyötä : pääjohtaja Erkki Korhonen on valmis jatkamaan Suomalaisen Tapiirin jalanjäljillä
Kuusi näytösisäntää Pula!-oopperalle
Tosca : opera in tre atti = kolminäytöksinen ooppera
Boris Godunov : Nelinäytöksinen ooppera = Opera in four acts : Aleksandr Puškinin samannimisen tragedian ja Nikolai Karamzinin "Venäjän valtion historian" pohjalta
Pula!-ooppera live-tallenteeksi
Nürnbergin mestarilaulajat : 3-näytöksinen oppera
Clarice oopperassa Il mondo della luna : näkökulmia ja taustatietoa roolihenkilöstä
Tosca : Opera lirica in tre atti = Kolminäytöksinen ooppera
Pientä jäykkyyttä ja täysosuman ainekset : pohjoisen ääniä Suomen Kansallisoopperassa
Totuus koetuksella : kokemuksellinen raportti oopperaproduktiosta
Nivala ei selviä oopperoista yksin : Kaupunki edellyttää lisää kustannusten jakajia, jos toiminta jatkuu
Toiset oopperassa Kaarle-kuninkaan metsästys : postkolonialistinen analyysi markkinakohtauksen juutalaisrepresentaatiosta
Joutilas mies on tehokkaasti kierrätetty : Nivalan toinen ooppera: Haanpään ja Wiina-Matin matka voi alkaa
Panulalta ooppera Pulan jälkeen : Pulaa esitetään vielä ensi kesänä, uusi ooppera kertoo Viina-Matista ja Haanpäästä
Aida : Nelinäytöksinen ooppera = Opera in quatro atti ; Teksti Camille du Loclen mukaan Antonio Ghislanzoni ; Suomennos Jussi Törnwall
Järjettömät koloratuurit : hullun naisen representaatio V. Bellinin oopperassa I Puritani
Mennään suoraan asiaan! : Jaakko Kuusiston Makuukamarioopperan jatko-osan voisi olla vaikka Papin poika
Paino sanalla yhteistuotanto : Kansallisoopperan ja oululaisen osaamisen yhdistäminen on kannattava ajatus
Elämän peruskysymysten äärellä : Paroni Paakkunaisen musiikkidraama Kaikkeuden ytimessä paneutuu kristinuskon sanomaan
Die verkaufte Braut = Myyty morsian
La Traviata : melodramma in tre atti = kolminäytöksinen ooppera
Joutilas mies tulee Nivalaan : Juha Hurme uuttaa Haanpää-oopperaan aineksia kirjailijan koko tuotannosta
Viimeiset kiusaukset viisi kertaa Nivalassa
Erkki Korhonen esittää uudenlaista oopperayhteistyötä : Kansallisooppera haluaisi tehdä oululaisten kanssa ensi-illan
La Fille du Régiment = Rykmentin tytär : opéra-comique en deux actes = kaksinäytöksinen koominen ooppera
Kuninkaallista oopperaa
Nainen vailla varjoa : kolminäytöksinen ooppera
Freelancerin pitää olla sosiaalinen : Petrus Schroderus ja Marco Stella tekevät Kopparbergissä Toscaa yhteistuumin
Belsebub pelaa peliään : Spoon River -kamariooppera on outo ja sirpaleinen, mutta sävelkieli miellyttää korvaa
Pieni palatsivallankumous : Oulun oopperayhdistys etsii kaupunginteatterin kanssa itselleen uutta roolia
Yhteinen ykseys : esitysanalyysi Robin Hood -oopperasta
Pula!-ooppera toiseen ensi-iltaan siivottuna : Kyösti Kallioon kohdennettua kritiikkiä vähennetty
Oulun oopperat teatterin vastuulle kolmeksi vuodeksi
Hoffmannin kertomukset = Les contes d'Hoffmann : viisinäytöksinen ooppera
Elämä on, sanoo herra Messenius : Oulun 400 -vuotisjuhlaoopperan voima piilee Olli Kortekankaan musiikissa
Kawerin kultamaa saa jatkoa Raahessa
Ilveilyä rakkauden nimissä : Oulun konservatorion oopperastudion Così fan tutte on riemukas komedia haksahtavista naisista ja epäilevistä miehistä
Tosca : 3-näytöksinen ooppera
Yleisö ihastui vankilatarinaan : Messenius -oopperan kantaesitys keräsi Oulun kaupunginteatterin täyteen kutsuvieraita
Ei saa pudota Liminkajokeen : Jukka Linkola sukeltaa ennen sävellystyön aloittamista mahdollisimman syvälle legendaarisen oopperalaulajan, Abraham "Aappo" Ojanperän, henkilökuvaan ja -historiaan
Punainen viiva : kaksinäytöksinen musiikkidraama = The red line : opera in two acts
Juntunen yllättäen Genovan oopperaan
Raahelaisten ooppera on merkkipaalu
Verdi-nainen : tutkimusmatka Verdi-sopraanon käsitteeseen Il Trovatore -oopperan Leonoran kautta
Pään pani pökkelöstä, seipäistä sääret : Koirien Kalevala Madetojan salin näyttämölle Oulussa
Oopperasäveltäjäksi oppimassa : Opera by You -verkkoyhteisö musiikillisen asiantuntijuuden kasvualustana
Last temptations = Viimeiset kiusaukset : opera in two acts
Rinnat pyörittävät Don Giovannia : Mozartin oopperan paras voima taidolla toteutetussa musiikissa
Soile Isokoski laulaa Tatjanan roolin ensi kertaa / STT
Uppo-Nalle orpona Oulussa ilman isää? : Vähän skandaalinkäryä ilmassa, kuten niin usein oopperoissa
Ooopperaa kaatopaikalle ja Kirkkopäiville : teatteri hävitti Kaikkeuden ytimessä -oopperan lavasteet - toivotut uusinnat saattavat silti toteutua
Messenius lähtee maailmalle : Oulun 400-vuotisjuhlavuoden tilausooppera tallentui levyksi
Aida : Nelinäytöksinen ooppera
Suvi Kinos vei mukanaan : lastenkirjallisuuden lähettiläs Kaisu Rättyä on mukana Konikapinasa
Verdin naamiohuvit syksyllä Oulussa : Jorma Uotista kosiskellaan mukaan oopperaan
Oopperakeskuksen toimintaa halutaan jatkaa
Jolanta : Yksinäytöksinen ooppera Op. 69
Salome : Musikdrama in einem Aufzug = 1-näytöksinen musiikkidraama
Oopperasanomat : Suomen kansallisoopperan asiakaslehti
Myyty morsian
Yhteistyö ei kaadu talousvaikeuksiin : pyrimme löytämään luovia ratkaisuja yhdessä oululaisten kanssa, lupaa Kansallisoopperan pääjohtaja Erkki Korhonen
The Red line = Punainen viiva
Hello! Hello? :  Roolianalyysi Gian Carlo Menottin The Telephonen Lucysta
Matka Reimsiin = Il viaggio a Reims
Mazeppa : 3-näytöksinen ooppera
Konikapina tarttui levylle : DVD: Pula! Ooppera konikapinasta
Pantalone Don Pelagion pinnan alla : commedia dell'arten vaikutus oopperaan
Nivalan kaupunki vääntää rahahanan kiinni
Il trovatore : Dramma in quattro atti : nelinäytöksinen ooppera
Don Giovanni liitää kukasta kukkaan : miksi donjuanismi elää yli vuosisatojen, kysyy ohjaaja Leena Salonen
Rockland jäi yleisötavoitteestaan, mutta oopperatoiminta jatkuu
Lappologinen orientti Launiksen Aslak Hetassa
Oopperan farmiliiga sopisi Ouluun : pääjohtaja Erkki Korhosen ehdotus yhteistyöstä lennättää ajatuksia puolin ja toisin
Njanja Filipjevna : roolityöni Keski-Suomen Alueoopperan tuotannossa Pjotr Tšaikovskin oopperasta Jevgeni Onegin taiteellisena oppimisprosessina
Pula!-lipuista varattu yli puolet
Projisointi näyttämötaiteen lavastuksessa
Lapsille suunnattu ooppera on vaikea laji : oululaisesta Uppo-Nalle löytää ystävän -oopperasta puuttui draamallinen kaari
Ensemble aloitti yhteisen matkan : Neljäntienristeys-oopperan roolit vievät tekijät fyysisesti tiukoille
Pohjalaista naurua oopperan kliseille
Lentävä hollantilainen : Suomenkielinen libretto
Opri ja Oleksi : 3-näytöksinen ooppera
Hirttonuoralleen allerginen Lusia : kamariooppera 1600-luvulla käräjillä tuomitusta kansanparantajasta nousi ennätystahtia Ahmaksen näyttämölle
Tristan und Isolde =  Tristan ja Isolde : Romantische Oper in drei Aufzügen = Kolminäytöksinen romanttinen ooppera
Oopperan äänittäminen
Musiikkidraama rippikoulun käyneille
Isovanhempien roolit puhuttelevat : tänään ensi-iltansa saavassa Pula!-oopperassa esiintyy joukko aikalaisten jälkeläisiä
Kelpo Ruusuritari : tärkeätä ei ole "mitä" vaan "miten"
Käärme livahti paratiisiin : ohjaaja lisäsi Naamiohuveihin Kuoleman
Laulun ja tanssi ooppera : harvoin nähty, oopperataidetta uudistanut Orfeus ja Eurydike ensi-iltaan Oulussa
Viitta (Il tabarro) : Yksinäytöksinen ooppera
Messeniuksen ja Lucian kuosit
Kaukainen rakkaus = L'amour de loin : 5-näytöksinen ooppera
Viimeiset kiusaukset tehdään ensi kesäksi
Espanjan kuningas Filip II : Verdin oopperan roolihenkilönä ja historiallisena henkilönä
Jevgeni Onegin : kolminäytöksinen ooppera
Kaukainen rakkaus : saavuttamattomuuden semantiikka Kaija Saariahon oopperassa
Puhelintreffit : uusi oululainen oopperaseurue Oodi kutsuu erityisesti nuoret puoleksi tunniksi The Telephoneen
Donizettin Lucia di Lammermoor ja bel canton maailma
Mikael Tariverdijev Odotus : Kertomus monologioopperan toteuttamisprosessista
Seuraavaksi koko illan ooppera
Köyhät lapset Hannu ja Kerttu oopperan tähtinä : Oulussa nähtävä Grimmin veljesten klassikko yhdistää oopperaa ja puheteatteria
Lentää lunta, jossakin räjähtää : Sotajoulukuu vei toiseen todellisuuteen
Pula! tahdotaan levylle : kalliit kustannukset mietityttävät levy-yhtiötä
Pohjalaisia luonnonvalossa : Ilmajoen 30-vuotisjuhlaooppera on vaikuttava ja huolella valmistettu
Tuhkimo : Kaksinäytöksinen koominen ooppera
Ooppera & baletti : Suomen Kansallisoopperan ja Kansallisbaletin asiakaslehti
Visuaalisessa ihmemaassa
Palatsi : Ooppera jossa on prologi ja kolme näytöstä
Ensi-ilta oli myrskyisä menestys : Nivalan ja koko Kalajokilaakson suururakalle kertyy tänä vuonna kaikkiaan 12 000-päinen yleisö
Leena Salonen vetää Punaisen viivan : kulttuurineuvos jatkaa Oulun kaupunginteatterin oopperatoimenjohtajana
Savonlinnan oopperajuhlat
Isän tyttö : kaksinäytöksinen ooppera
Rosenthalin lapset : 2-näytöksinen ooppera
Nivala mukaa oopperakeskukseen
Patarouva : kolminäytöksinen ooppera = Pikovaja dama
Aida : Nelinäytöksinen ooppera : Libretto ; Teksti Camille du Loclen mukaan Antonio Ghislanzoni ; Suomennos Jussi Törnwall
Kirjailija Haanpää inspiraatiota etsimässä
Demoni = The demon : 3-näytöksinen ooppera
The red line = Punainen viiva : opera in two acts
Chydenius sukelsi Kawerin maailmaan : oopperan säveltäminen vei historiaan ja kirjailija Airi Haatajan tarinoihin
Kuningas Lear : Kaksinäytöksinen ooppera
Elektra : Tragödie in einem Aufzug = Yksinäytöksinen murhenäytelmä
Katerina Izmailova : Ooppera
Valkea kyyhkynen ja vahvat egot : Lusia Rusintytär kokoaa parantajan kohtalon pienistä palasista
Macbeth : Opera in quattro atti : Nelinäytöksinen ooppera ; Libretto Shakespearen draaman mukaan Francesco Maria Piave ; suomennos Jussi Törnwall
Johannes Messenius oli aika moderni mies : Oulun 400-vuotisjuhlaooppera pyrkii kiinni ihmiseen muotokuvan takana
Ooppera jatkuu Nivalassa : Jokilaaksojen musiikkisäätiö perustettiin tuottamaan konsertteja ja oopperaa
Die Walküre = Valkyyria : Oper in drei Aufzügen : kolminäytöksinen ooppera
Messenius-oopperasta suunnitellaan kiireellä levytystä : Ondine lupautunut julkaisijaksi
Kaarle-kuninkaan metsästyksestä Ringiin : näkökohtia oopperataiteen ohjauksen ja lavastuksen kehityksestä Suomessa vuosina 1852-2000
Ihmisääni : Raportti monologioopperan synnystä
Sukellus tuntemattomaan : La Canterina -oopperan ohjaus
Nivalaan Suomen suurin sisäteatteri : kesäkuussa ensi-iltaan tulevan Pula!-oopperan katsomoon mahtuu 1500 henkeä
Sirkusprinsessa on operettiviikon tähti : Nivalassa Joutilas mies -oopperan harjoitukset pyörivät vilkkaimmillan
Pula! -oopperalle palkinto
Capuletit ja Montecchit = I Capuleti e i Montecchi
Oopperakeskus tekee tappiota : Nivalan kaupunginhallitus tyrmistyi Pula!-oopperan loppusaldosta
Kuka on Carmen? : näkemyksiä George Bizet'n suosikkioopperan nimiroolista
Rocklandin rahoitus varmistunut
Akateemikko rupesi taas visertämään : Jorma Panulan uusin ooppera kantaesitetään Nivalassa, mutta säveltäjä eiehdi paikalle
Aslak Hetta : Kolminäytöksinen ooppera
Suomalainen oopperatutkimus nyt - ja miltä se voi näyttää tulevaisuudessa
Tytöstä naiseksi : Paminan roolin esittäminen W. A. Mozartin oopperassa Taikahuilu
Kung Karls jakt : opera i tre akter = Kaarle-kuninkaan metsästys : kolminäytöksinen ooppera
Ryöstö seraljista : kolminäytöksinen ooppera = Die Entführung aus dem Serail
Don Carlos : Nelinäytöksinen ooppera
Pula!-ooppera kuin kotisynnytys
Suomen sota marssii Ouluun : kaupunginteatteri tuottaa uusia musiikkiprodukioita ja miettii oopperayhteistyötä
Oopperasotku aiotaan välttää hyvällä suunnittelulla
Kaarle kuninkaan metsästys : kolminäytöksinen ooppera
Tiivistelmä.
Rahaa ei heru Nivalan naapureilta : oopperan merkitys nähdään suureksi alueen minäkuvalle ja itsetunnolle
Aappo on oopperansa ansainnut : liminkalaisen oopperalaulajan ja laulupedagogin Abraham Ojanperän elämään perustuva ooppera juhlistaa sekä Suomen satavuotisjuhlavuotta että Limingan 540-vuotista historiaa
Der Rosenkavalier : Kolminäytöksinen musiikkikomedia
Prinssi ei voi olla mikään kukkakeppi : Petrus Schroderus ja Helena Juntunen tapasivat Taikahuilun ensi-illan alla
Salome : 1-näytöksinen musiikkidraama ; Saksankielinen teksti Hedwig Lachmann ; Suomennos (ei laulettavaksi tarkoitettu) Jussi Törnwall
La Cenerentola = Tuhkimo : kaksinäytöksinen koominen ooppera
Puhdistus kääntyi hallituksi oopperaksi
Kyösti Kallion pulamaine puhdistuu : Pula!-ooppera saa lisäväriä uudesta aariasta ja muutetusta Kallion osuudesta
Madame Flora tuli : kymmenien roolien kokemuksella Marjatta Airas panee Meedio-oopperaan vauhtia
Ratsumies = Der Reitersmann : kolminäytöksinen ooppera
Messenius oli vaikea läheisilleen : Hannu Niemelä pitää roolihenkilönsä inhimillisyydestä
Valo partituurissa : Valosuunnittelu kokonaistaideteoksessa ooppera
Naamiohuvit = Un ballo in maschera : nelinäytöksinen ooppera
