http://www.yso.fi/onto/yso/p11172 image of Russia
image of Russia
Russia : nine hundred years of masterpieces and master collections
The American image of Russia, 1775-1917
U morâ Belogo, studenogo... : [fotokniga] = By the cold White sea..
Mikhail Vrubel : paintings, graphic works, sculptures, book illustrations, decorative works, theatrical designs
Hryscìânskìâ hramy Belarusì na fotazdymkah Âna Balzunkevìča : pačatak XX stagoddzâ = Christian churches and temples of Belarus in the pictures of Ian Balzunkevich, early XX century
Russia under Western eyes : from the Bronze Horseman to the Lenin Mausoleum
Pìnsk : čaroǔnaâ kazka Palessâ = Pinsk : volšebnaâ skazka Poles'â = Pinsk : a fairy tale of Polessye
The cinema of Alexander Sokurov
Russia in pictures : from Moscow to Samarkand
Photographs for the Tsar : the pioneering color photography of Sergei Mikhailovich Prokudin-Gorskii commissioned by Tsar Nicholas II
Dve vody : fotografii = Two waters : photographs
Neighbour images in Finland and the Soviet Union : a comparative study among 16-17 year old schoolchildren
Gorad SONca : vìzual'naâ paèma u troh častkah = The sun city of dreams : a visual poem in three parts
SELECTED WORKS OF RUSSIAN ART : ARCHITECTURE, SCULPTURE, PAINTING, GRAPHIC ART : 11TH - EARLY 20TH CENTURY
Monogrammy i inicialy v rossijskom i sovetskom èkslibrise, 1850-1994 = Monograms and initials on Russian and Soviet exlibris, 1850-1994
Russki narodnyi kostjum : iz sobranija Gosudarstvennogo muzeja etnografi narodov SSSR : from the collection of the State ethnographical museum of the people of the USSR = Russian folk clothing
Pad nebam Belarusì : fotoal'bom = Beneath the sky of Belarus
The art and architecture of Russia
Iskusstvo kaslinskih masterov = The art of Kasli masters. Kniga 2, Mebel', kabinetnaâ skul'ptura, Kaslinskij čugunnyj pavil'on
The man without a face : the unlikely rise of Vladimir Putin
Russia in original photographs 1860-1920
Panoramy Sankt-Peterburga = Panoramic views of St Petersburg = Vues panoramiques de Saint-Pétersbourg
The Russian Empire : a portrait in photographs
New civic neighborhood : cross-border cooperation and civic society engagement at the Finnish-Russian border
Kremlin rising : Vladimir Putin's Russia and the end of revolution
Mikhail Larionov and the cultural politics of late imperial Russia
Sex and Russian society
Maâ zâmlâ : Žyvapìs belaruskìh mastakoǔ = My land : paintings of Belarusan [sic] artists
Arts of Russia : from the origins to the end of the 18th century
Selected works of Russian art : architecture, sculpture, painting, graphic art : 11th-early 20th century
Beyond the empire : images of Russia in the Eurasian cultural context
Images and mutual perceptions of the Finns, the Estonians and the Russians in the 20th century
Solovetsk islands : symmetry of spirits
Iskusstvo kaslinskih masterov = The art of Kasli masters. Kniga 1, O Kaslâh, stranicy nenapisannyh biografij, i ruku priložil hudožnik
Photographs catalogue : Saint-Petersburg-Moscow-London = Fotografii katalog : Sankt-Peterburg-Moskva-London
Russia in Finnish business media
Selected works of Russian art : architecture, sculpture, painting..
Kirill Sokolov : a retrospective: paintings &sculpture
The knight, the beast and the treasure : a semeiotic inquiry into the Finnish political imaginary on Russia, 1918-1930s
Architecture of the russian north : 12th-19th centuries
Russia 2030 based on contracts
Art-galereâ Krasnyj most : izbrannoe = Art-gallery Red bridge : selected works
A portrait of tsarist Russia : unknown photographs from the Soviet archives
Tsarskoye selo : the Imperial summer residence
Russia as the subconsciousness of Finland
Old Russian painting : latest discoveries : obonezhye painting 14th-18th centuries
Aleksandr Kuprin and Finland
Foreign policy of the communists
Selected works of Russian art : architecture, sculpture, painting, graphic art
Ot portreta k ikone : očerki russkoj ikonografii XVIII -načala XX veka = From portrait to icon : studies in Russian iconography of the eighteenth - the beginning of the twentieth centuries
Archipenko : sculpture, drawings and prints, 1908-1963
Sankt-Peterburgskaâ Gosudarstvennaâ hudožestvenno-promyšlennaâ Akademiâ k 125 letiû osnovaniâ : monumental'no-dekorativnoe iskusstvo i dizajn = Saint Petersburg State Academy of Art & Design 125th anniversary : monumental and decorative art & design
Under other eyes : constructions of Russianness in three socio-political english novels
Pirosmani : selected works
Belarus' : partrèt na fone peramen = Belarus : a story of change
Iskusstvo Dagestana : reznye kamni = The Art of Daghestan : Caryed stones
The two faces of St. Petersburg
Tobol'sk : arhitekturnoe nasledie v fotografiâh = Tobolsk : architectural heritage in photographs
Abstraction in Russia XX. century. Vol. 2
Abstraction in Russia XX. century. Vol. 1
The great experiment : Russian art 1863-1922
Baškortostan : zdes' Evropa vstrečaetsâ s Aziej = Bashkortostan : Europe and Asia meet there
Foreign descriptions of Muscovy : an analytic bibliography of primary and secondary sources
The internationalisation of Russian studies in Finland
Alexandre Rodtchenko : photographies 1924-1954
Lomonosov : dvorcy i parki = Palaces and parks
Istoriâ Rossijskogo flota = The history of the Russian navy
Imperial St. Petersburg : pages from history 1703-1917 : paintings, prints and drawings, sculpture, applied art, everyday objects, posters, porcelain and glass
A people born to slavery : Russia in early modern European ethnography, 1476-1748
Euro-Orientalism : liberal ideology and the image of Russia in France (c. 1740-1880)
Constructivism in film : the man with the movie camera : a cinematic analysis
Palaces and parks : the State Museum-Reserve Oranienbaum
