http://www.yso.fi/onto/yso/p18533 aromatherapy
aromatherapy
Hydrosols : the next aromatherapy
Natural health & bodycare : a comprehensive and informative guide to natural remedies, recipes and routines for the whole body
"Welcome to the world of alternative medicine. Prince Charles is a staunch defender and millions of people swear by it; most UK doctors consider it to be little more than superstition and a waste of money. But how do you know which treatments really heal and which are potentially harmful? Now you can find out. Edzard Ernst is the world's first professor of complementary medicine and Simon Singh is the author of several international bestsellers. Together they have written the definitive book on aletrnative medicine. It is honest, impartial, hard-hitting and provides a thorough examination and judgement of more than thirty of the most popular treatments, including: -acupuncture, -homeopathy, -aromatherapy, -reflexology, -chiropractic, -herbal medicine. Whether you are a follower, sceptic or just baffled by the subject, Trick or Treatment? delivers the ultimate verdict on alternative medicine with clarity, scientific rigour and absolute authority." -- (Back Cover)
Flower essence repertory : a comprehensive guide to North American and English flower essences for emotional and spiritual well-being
The secret of a heart note
Aromatherapy : patients' opinion
Natural, alternative, and complementary health care practices
Nature's beauty secrets : recipes for beauty treatments from the world's best spas
Trick or treatment? : alternative medicine on trial
The aromatherapy bible : the definitive guide to using essential oils
The Massage Manual : massage, aromatherapy, shiatsu, reflexology
Aromatherapy an A-Z
New Age capitalism : making money east of Eden
Sacred luxuries : fragrance, aromatherapy, and cosmetics in Ancient Egypt
Complementary therapies for physical therapists
Veterinary aromatherapy : natural remedies for cat, dogs, horses and birds, and for the rearing of calves, cows, pigs, goats, sheep, chicks, chickens, ducks and geese
Angel Detox : taking your life to a higher level through releasing emotional, physical and energetic toxins
Chemical composition of a commercial oil of Ravensara aromatica Sonn. used in aromatherapy
556 aromatherapy formulas for mind & body
Angel detox : taking your life to a higher level through releasing emotional, physical, and energetic toxins
Handbook of essential oils : science, technology, and applications
The Body Shop book : skin, hair and body care
An aroma expert embarks on what she fears will be a life of solitude and dreams of a normal high school existence before an accident leads to an unexpected forbidden romance / WorldCat.
The essential guide to natural skin care : choosing botanicals, oils & extracts for simple & healthy beauty
THE ENCYCLOPEDIA OF COMPLEMENTARY MEDICINE
Instant aromatherapy for stress relief : simple tension treatments and relaxation recipes
The illustrated encyclopedia of essential oils : the complete guide to the use of oils in aromatherapy and herbalism
The aromatherapy garden : growing and using scented plants
Tea tree oil : nature's miracle healer
Aromatherapy : a definitive guide to essential oils
The art of aromatherapy
Relaxation : exercises and inspirations for well-being
The chemistry of essential oils : an introduction for aromatherapists, beauticians, retailers and students
Invitation to holistic health : a guide to living a balanced life
Aromatherapy : simple routines for home, work, & travel
Incense : crafting & use of magickal scents
Insomnia : take control of your health naturally
Simply relax : the beginner's guide to relaxation
Essential oil safety : a guide for health care professionals
Body and soul : create your own spa
An application of ontology technology in the semantic web within aromatherapy domain
Aromatherapy in midwifery practice
Create your own perfumes using essential oils
Milady's standard : nail technology
Aromatherapy and the mind : [an exploration into the psychological and emotional effects of essential oils]
The essential guide to oils : all the healing oils you will ever need for well-being and vitality
Holistic nursing care
Chakra awakening : transform your reality using crystals, color, aromatherapy & the power of positive thought
Aromatherapy solutions : essential oils to lift the mind, body and spirit
The nurse's handbook of complementary therapies
Aromatherapy : the encyclopedia of plants and oils and how they help you
The encyclopaedia of essential oils : the complete guide to the use of aromatics in aromatherapy, herbalism, health & well-being
The healing garden : a practical guide for physical & emotional well-being
Massage, aromatherapy & yoga : practical handbook
The magic of flowers : a guide to their metaphysical uses & properties
The complete aromatherapy tutor : a structured course to achieve professional expertise
Professional beauty therapy : the official guide to level 3
The encyclopedia of aromatherapy, massage and yoga
