http://www.yso.fi/onto/yso/p24969 physical exercises
physical exercises
Breathe strong, perform better
Dynamic stretching : the revolutionary new warm-up method to improve power, performance and range of motion
Auditory Communication for Deaf Children : A Guide for Teachers, Parents and Health Professionals
Crystal mindfulness : still your mind, calm your thoughts and focus your awareness with the help of crystals
Tests and exercises for the spine
Volleyball systems & strategies
The mindfulness journal : exercises to help you find peace and calm wherever you are
Therapeutic exercise for musculoskeletal injuries
How to relax
Semioccluded vocal tract exercises : a physiologic approach for voice training and therapy
Diastasis recti : the whole-body solution to abdominal weakness and separation
The Scientific and clinical application of elastic resistance
The way of mindful education : cultivating well-being in teachers and students
Body by you : the you are your own gym guide to total fitness for women
How to coach a soccer team : professional advice on building a winning team
The anger fallacy workbook : practical exercises for overcoming irritation, frustration and anger
Mindfulness on the go : peace in your pocket
Mindfulness pocketbook : little exercises for a calmer life
A mindfulness guide for the frazzled
The mind's ear : exercises for improving the musical imagination for performers, composers, and listeners
Rudimental warm-ups : skill-strengthening exercises fo all drummers
Games for actors and non-actors
Activities for teaching positive psychology : a guide for instructors
The urban monk : Eastern wisdom and modern hacks to stop time and find success, happiness, and peace
Deep listening : a composer's sound practice
The empathy challenge : how to become an empathic graphic designer
Daily meditations for calming your angry mind : mindfulness practices to free yourself from anger
The kinesthetic classroom : teaching and learning through movement
T'ai chi step by step : a fully illustrated teaching plan, shown in over 250 photographs
Mathematical thinking: how to develop it in the classroom
Back in shape : a back owner's manual
Jumping into plyometrics
Strength training bible : the complete guide to lifting weights for power, strength & performance
The outdoor athlete
