http://www.yso.fi/onto/yso/p8457 sexual guides
sexual guides
Better sex in no time : an illustrated guide for busy couples
Fifty shades of bondage & submission : a beginner's guide to BDSM
The sex factor : the essential teen guide
The sex manual
Kama Sutra : a position a day 365 days a year
Spartacus : international gay guide. 2003/2004
Sexploration : welcome to the pleasure zone
Anne Hooper's Kama Sutra : classic lovemaking techniques reinterpreted for todays' lovers
The act of marriage : the beauty of sexual love
The lesbian sex bible : the new guide to sexual love for same-sex couples
Outspoken women : an anthology of women's writing on sex, 1870-1969
Sexual intelligence : what we really want from sex - and how to get it
Divine sexuality : the joy of tantra
An introductory guide to the sacred sexuality practices of modern schools of Tantra, and how you can use them to find meaning and healing in physical relationships.
Bondage for beginners : tie-me-up tricks and knots
The ten minute sexual solution : a busy couple's guide to having more fun, intimacy, and sex
Tantra : how our relationships can become a path for spiritual growth
Sex, puberty and all that stuff : a guide to qrowing up
Love in the time of colic  : the new parents' guide to getting in on again
Bonk : the curious coupling of sex and science
Enjoy sex : (how, when and if you want to) : a practical and inclusive guide
100 hot sex positions
The language of sex : experiencing the beauty of sexual intimacy
The joy of sex
The joy of mindful sex ; be in the moment & enrich your lovemaking
The sex book
English summary: Sexuality education material.
The Tao of sexology : the book of infinite wisdom
Sexpectations girl
Kama sutra : including the seven spiritual laws of love
The art of sexual magic : how to use sexual energy to transform your life
A woman's guide to sex
What every girl sould know
New art of capturing love : the essential guide to lesbian and gay wedding photography
Friendly fetish : a beginner's guide to kink
Zen sex : the way of making love
The perfumed garden
Sex, snogs, dates and mates
Dont put that in there! : and 69 other sex myths debunked
Adolescent readers' responses to the booklet on sex
Becoming orgasmic : a sexual and personal growth program for women
Come as you are : the surprising new science that will transform your sex life
The new sex bible for women : the complete guide to sexual self-awareness and intimacy
Report on the Toolkit : advocating for sexual and reproductive health and rights of young people and youth participation
Sexpertise : real answers to real questions about sex
The art of Kamasutra
Unzipped : a toolkit for life
365 sex moves : positions for having sex a new way every day
The birth of mankind : otherwise named, The woman's book : newly set forth, corrected, and augmented : whose contents ye may read in the table of the book, and most plainly in the prologue
Explosive sex! : step-by-step techniques for the hottest sex ever
The rules of love : the 64 arts of the kama sutra
Sexual intelligence : what we really want from sex and how to get it
Anne Hooper's ultimate sexual touch : a lover's guide to sex through sensuality
Desire : the tantric way to awakening
Sex education for young Muslims
