http://www.yso.fi/onto/yso/p10274 visuell kultur
visuell kultur visuell kultur
Taidekasvatuksen Helsinki : lasten ja nuorten taide- ja kulttuurikasvatus
Allt eller inget : kritisk teori, samtidskonst och visuell kultur
Lost in translation? : att översätta allusioner och ordlekar i Gilmore Girls
Nu dyker jag! : ett hopp in i seriernas okända vatten
Iconographisk post : Nordisk tidskrift för bildtolkning
Visby visuellt : föreställningar om en plats med utgångspunkt i bilder och kulturarv
Upplevelseindustrins turistmiljöer : visuella berättarstrategier i svenska turistanläggningar 1985-2005
Konst och visuell kultur i Sverige före 1809
Kläder som språk och handling : om unga kvinnors användning av klädseln som kommunikations- och identitetsskapande medel
Oikeuden näyttämöt : kuvallisuus lain käytössä = Rättvisans skådebanor : symbolik och visualitet inom rättsskipningen = Venues of justice : symbolic visuality in law / toimittaja = redaktör = editor Virpi Harju
Studier till bildens och konstens historia : en forskningsteoretisk introduktion
Bilden i det postmoderna samhället : konstbild, massbild, barnbild / Gert Z. Nordström
Beundran av schlagerstjärnan Jari Sillanpää : En undersökning om VeiJari fanklubbens symboliska betydelser och gemenskap
Bilden tiger inte : rapport från arbetsgruppen för utbildning i visuell kultur
Effektiv visuell kommunikation : om nyheter, reklam och profilering i vår visuella kultur
Film och andra rörliga bilder : en introduktion
Text, bild, samhälle
Effektiv visuell kommunikation : om nyheter, reklam, information och profilering i vår visuella kultur
Från kungaporträtt till läsketikett : en domänanalytisk studie över Kungl. bibliotekets bildsamling med särskild inriktning mot katalogiserings- och indexeringsfrågor
Kuvallisuus oikeuskulttuurin osana = Symbolik och visualitet som en del av rättskulturen = Symbolic visuality in legal culture / Virpi Harju, Heikki E. S. Mattila
Härskarkonst : Napoleon, Karl Johan och Alexander
Visby visuellt : Föreställningar om en plats med utgångspunkt i bilder och kulturarv
Bilder som fascinerar : behoven, smaken, tidsandan / Lars Peterson
Om skönhet
Mellan norm och avvikelse i synlig kultur – piktoral, plastisk och ikono‐plastisk retorik i bilder och mönster
Konst och visuell kultur i Sverige. 1810-2000
Bild och samhälle : visuell analys som vetenskaplig metod
Visuella arenor och motsägelsefulla platser : tio texter om transformativt lärande, identitet och kulturell förändring
Fotografen Max Petrelius och modernismen i hans modefotografering 1962-1973
Det figurala och den rörliga bilden : om estetik, materialitet och medieteknologi hos Jean Epstein, Bill Viola och Artintact
Liksom en herdinna : litterära teeman i svenska kvinnoporträtt under 1700-talet / Carolina Brown
Amerikafantasier : kön, medier och visualitet i svenska reseskildringar från USA 1945-63
Visuella spår : bilder i kultur- och samhällsanalys
Mörkrum & transparens : studier i europeisk bildkultur och i bildens historiska evidens
Bild, visualitet och vetande : diskussion om bild som kunskapsfält inom utbildning
Blickens ordning : bildspråk och estetiska lärprocesser som kulturform och kunskapsform
Textilt skapande som estetisk-etisk transformation : om medierat lärande i vårdutbildning
Kulturen i informationssamhället : de strategiska grunderna och utgångspunkterna för undervisningsministeriets handlingsprogram 1997-2000
Visuell kultur i barns vardagsliv : bilder, medier och praktiker
Barns visuella kulturer : skolplanscher och idolbilder
Blond och blåögd : vithet, svenskhet och visuell kultur = Blond and blue-eyed : whiteness, Swedishness, and visual culture
