http://www.yso.fi/onto/yso/p13763 Reggio Emilia-pedagogik
Reggio Emilia-pedagogik Reggio Emilia-pedagogik
Exemplet Reggio Emilia : pedagogik för demokrati och lokal utveckling
Emancipation och motstånd : dokumentation och kooperativa läroprocesser i förskolan
Om ögat fick makt : mer om de hundra språken och den skapande pedagogiken i Reggio Emilia
En studie av Reggio Emilia-inspirerat arbetssätt vid Barnabo daghem
Från Fröbel till Reggio Emilia : om bild och skapande verksamhet i förskolan
Från Fröbels gåvor till Reggios regnbåge : [om alternativ före skolan]
Barns estetiska läroprocesser : atelierista i förskola och skola
Varför pedagogisk dokumentation?
Visionärerna
Pedagogiska kullerbyttor : en bok om svenska barn och inspirationen från Reggio Emilia
Flygande mattor och forskande barn : om filosofin på ett daghem i Helsingfors jämfört med tankarna i Reggio Emilia
Från fakta till fantasi : om temaarbete utifrån skapande ämnen och lek
Vad kan vi lära av Reggio Emilia?
Boken om pedagogerna
Lyssnandets och seendets villkor : pedagogisk dokumentation - DVD bok
Goda lärmiljöer för barn
En skola som berör : Reggio Emilia-inspiration i skolan
Mannen från Reggio Emilia
Hur vi lär oss är vår styrka : från inlärningssvårigheter till insikt
Bland dokumentationer, reflektioner och teoretiska visioner : idéer och diskurser om hur barn skapar mening i förskolan
Fantasins grammatik : introduktion till konsten att hitta på historier
Föräldrars förväntningar på den pedagogiska dagvårdsverksamheten inom olika pedagogiska inriktningar
Erfarenheter från förskolan i Reggio Emilia
Mer om hundra språk : Moderna Museet, Stockholm 16.8. - 5.10. 1986
Reggio Emilia och de hundra språken
Hundra sätt att tänka : om Reggio Emilias pedagogiska filosofi
Hundra sätt att förundras : pedagogik i en föränderlig omvärld
Staden och regnet : ett temaarbete på daghem i Reggio Emilia : steg för steg
Ett barn har hundra språk : om skapande pädagogik på de kommunala daghem i Reggio Emilia, Italien
D - som Robin Hoods pilbåge : ett kommunikationsprojekt på daghemmet Diana i Reggio Emilia
Dokumentation och bevaring
Blickens ordning : bildspråk och estetiska lärprocesser som kulturform och kunskapsform
Språkfärdigheter och läroprocesser : estetiska och didaktiska perspektiv
Ljuspunkten : barns relation till fenomenet och begreppet ljus
Blå cikoriablommor : ateljén i Reggio Emilias pedagogiska verksamhet
Förskoleundervisning : början på ett målinriktat lärande
Malaguzzi : grundare av Reggio Emilias förskoleverksamhet
Om värden och omvärlden : pedagogik i praktik och teori med inspiration från Reggio Emilia
