http://www.yso.fi/onto/yso/p13842 medievetenskap
medievetenskap medievetenskap
Om katarr i mellersta örat
Vad jurister behöver veta om medier
Den massmediala (re)produktionen av turismens platser : geografiska perspektiv på journalistikens uttryck och produktionsförhållanden
"Nästan som en författare" - multimedialt berättande : utforskande av lärande om och i berättande med inspiration från Vygotskij
Netnografi : etnografiska undersökningar på nätet
Det talande offret : journalistik vid olyckor och katastrofer
Genuspedagogik : en tanke- och handlingsbok för arbete med barn och unga
Att leva som utbränd : en etnologisk studie av långtidssjukskrivna
Att förädla information till kunskap : lärande och klassrumsarbete i mediesamhället
Massturismens mediegeografi : Mallorca i tre svenska dagstidningar 1950-2000
Genetiska föreställningar : mellan genus och gener i populär/vetenskapens visuella kulturer
Vägen till vinnarcirkeln : travhästen och dess människor mellan sport och spel
Belägrade människor - belägrade rum : om invandrargöranden och förorter
Mediekultur, mediesamhälle
Metoder i kommunikationsvetenskap
Intertextuella strövtåg i Akademia : måhända som en galaktisk reseskildring anno 1998
Vilken metod är bäst - ingen eller alla? : metodtillämpning i medie- och kommunikationsvetenskap
Metodbok för medievetenskap
Grafisk kommunikation
Afhandling om det medlersta örats catarrh
Att läsa medietext : en introduktion till mediepedagogiken
Digital kompetens i undervisningen : [handbok för lärare i samhällsvetenskapliga ämnen]
På väg mot medievärlden 2020
På drömmarnas marknad : ikoner, fantasibilder och klichéer i populärkulturen
Bortom oskuldens tid : en etnologisk studie av moral, trygghet och otrygghet i skuggan av hiv
Kulturella mötesplatser i tid och rum
Bild och samhälle : visuell analys som vetenskaplig metod
Medier och kultur : en grundbok i medieanalys och medieteori
Backpacker. 3
Internetpublicering och sociala medier : en juridisk vägledning
Jorden : globala förändringar : Moderna Museet, Spårvagnshallarna, 4.6.-9.10. 1994
De odödliga : förhistoriska individer i vetenskap och media
Talkshowens väsen : en komparativ studie av en tv-genres uttryck i USA, Finland och Sverige
På väg mot medievärlden 2020 : journalistik, teknik, marknad
Under utgivning : den vetenskapliga utgivningens bibliografiska funktion
Utbilda via Internet : handbok i IT-pedagogik. 1
Mångfald i medieforskningen : symposium, Malmö högskola 24-25 april 2002
