http://www.yso.fi/onto/yso/p14909 kulturkritik
kulturkritik kulturkritik
Allt eller inget : kritisk teori, samtidskonst och visuell kultur
Skådespelssamhället
Den goda beröringen : om kropp, hälsa, vård och litteratur
Medier, samhälle, kommunikation
Sociala konflikter och kulturella processer : historia med människor i centrum
Det infantila samhället : barndomens slut
Kulturjournalistikens grunder
Oro : en resa i det moderna självet
Strage text : samlade artiklar av Fredrik Strage
En rad frågor
Bild och dialektik
Kritikmaskinen : och andra texter
Kultur - text - språk : det finns mer i en text än ord
No logo : no space, no choice, no jobs, no logo : märkena, marknaden, motståndet
Igboäktenskapet ur antropologisk och skönlitterär synvinkel : en litteraturantropologisk granskning
I smältdegeln :  inlägg och skisser
Den rätta tonen - eller kitsch? : om äkthetskrav i den mellaneuropeiska kulturdebatten runt 1900
Hat & bläck : en dialog om klasshat, litteratur och människans värde
Hedersmorden och orden : berättelser om kultur, kritik och skillnad
Skolboken : först när man värmer pärlplattan hänger allt ihop
Klädd i sitt språk : kritikern Olof Lagercrantz
Koltrasten som trodde att den var en ambulans
Rysk dagbok
Kulturstudier : nyckelbegrepp för nybörjare
Tankens utåtvändhet : Georg Henrik von Wright som intellektuell
Ellen Key om böcker och läsning : en studie
Nostalgisk längtan och iskallt förnuft : Claude Lévi-Strauss som civilisationskritiker
Historiska och litteraturhistoriska studier. 87
Tomhetens triumf : (om grandiositet, illusionsnummer & nollsummespel)
Till matens försvar
Humanismen som livshållning och andra essayer
Litteraturens nätverk : bertättande på internet
Att färdas under dödens tecken : Frazer, imperiet och den försvinnande vilden
Samtiden bakom oss : esser och kommentarer 1992-2004
Att störa homogenitet
Helena Westermarck : intellektets idoga arbetare
Konst, makt och politik
Makeovermani : om Dr Phil, plastikkirurgi och illusionen om det perfekta jaget
Vem har snott mitt land?
Litterära smakdomare : ett urval inflytelserika tidningar och tidskrifter i Europa, USA och Sovjetunionen
Koltrasten som trodde att den var en ambulans : [en bok om ljud]
Kamp med förnuftet : rysk kritik av västerländsk rationalism
Det europeiska samhällets begynnelser : en inbjudningsskrift
Civilisationskritisk historieforskning om folk- och grundskolan i Finland
Halim går på högstadiet och har nyligen flyttat från Skärholmen till Söder där han nu bor ensam med sin pappa. Halim drömmer om att bli en tankesultan och om att återupprätta alla blattars heder. Skriven på Rinkebysvenska.
Högkultur som subkultur? : inledande anföranden vid ett seminarium i Börssalen den 29 mars 2006
Materialsamling rörande Finlands kritikerförbunds (SARV:s) verksamhet samt Lars Hambergs och en del kollegers deltagande i kulturdebatten där bl.a. kritikteoretiska synvinklar pekar ut olika tidsmässiga kulturlinjer
Ljusets fiender : västvärldens självkritik och den svenska idédebatten
Ekologi, samhälle och livsstil : utkast till en ekosofi
Svenskfinland - den seriösa kritikens sista utpost? : En studie i litteraturkritikens historia och undersökning av recensioner i elva finlandssvenska dagstidningar
Det stora okända : kulturkritiska essäer
Generation Ego : att fostras i en narcissistisk kultur
Från exilen : [essäer 1976-2000]
Myten om maskinen : essäer om makt, modernitet och miljö
Poeten och tiden : essäer 1922-1932
"De tusinde kameraers land" : systemisk-funktionall analys av finlandbilden i danska konstrecensioner
Folkhemmets skuggbilder : en kulturanalytisk genrestudie av svensk kriminalfiktion i film och TV
Korkade vita män : ...och andra billiga svepskäl för tillståndet i nationen
"Är du en reklam?" : social konst mitt i stadens brus
Genom ett sekel : profiler och anteckningar
Det muslimska problemet : en maning till uppriktighet och förändring
När kultur blir natur : texter i urval 1989-2013
Ögonblickets tyranni : snabb och långsam tid i informationssamhället
Lyx och mode i stormaktstidens Sverige : Jesper Swedberg och kampen mot perukerna
Ottos liv : en samtidsroman
Litteraturens uppodling : läsesällskap och litteraturkritik som politisk strategi vid sekelskiftet 1800
Vakthållning : valda uppsatser ur tidigare skrifter
"Nya medier" - men samma gamla barnkultur? : om det tredje könets lek, lärande och motstånd via TV, video och datorspel
Svenskfinland - den seriösa kritikens sista utpost? : en studie i litteraturkritikens historia och undersökning av recensioner i elva finlandssvenska dagstidningar
