http://www.yso.fi/onto/yso/p17494 artenomer
artenomer artenomer
Köket - hemmets centrum : Inredningsplanering av ett kök från tidigt 1900-tal
Kerttu : produktutveckling av ett datorbord, ett samarbete med Studio Salovaarat Oy
Inredning av en lägenhet inspirerad av retrostil
Aina : en vårkollektion
Färger och inredning av ett väntrum
En kollektion för HAPPYsthlm
Fiona : en fönsterinspirerad skärm
Behov av och idéer till dagverksamhet för pensionärer i Nykarleby kommun
De första 180 åren av slöjd, hantverk, formgivning i Åbo
"feetgood" - "feelgood" : mattserie till Kateha Ab, Sverige
Ett gammalt hus får ett nytt liv
Fröken Snö : konsttextil till Nordea bank i Kimito
En resegarderob med inspiration från 1960-talets mode
Kalskär : ett utdragbart matbord med låda
1+1>14 : att kombinera keramik och textil inom sysselsättande verksamhet
Dräkter från en sagovärld : en kollektion inspirerad av John Bauers sagomålningar
RePro : konsttextil till AstraZeneca
CHiMA. Klädd i identitet
Geo : en kollektion yllekappor med geometriskt ytmönster
Examensarbete
Men with attitude : en sommarkollektion herrkläder
Lyx av lump : om återanvändning och nyskapande i formgivning av kläder
Juvelerna af Hovimäki : en kollektion festklänningar inspirerade av fem kvinnliga rollfigurer ur TV-serien Hovimäki
Från skarf till skarf via slips : ett sätt att återvinna slipsar
Unisono : unisexkollektion för barn i storlek 116
Ett personligt koncept : en kundanpassad rumsavdelare
Korridormöbeln : en sits för smala utrymmen
Naava & Aamu-Kaste : älvor som fick liv genom dansteaterkostymer
Patinering : ett arbetssätt med många metoder
Bindmössor och ankarknappar
Onni : en löpare i mönstrad ripsväv åt Taito Shop kedjan
Sigurd : en väggbonad i vikingastil
Inredning av personalutrymme på Sydväst Sjöfart
Chiquitita queens : flätade klänningar redo för scenen
Projekt: Palmapirtti : planering av textilmönster till Karleby stads representationsbastu
Firma Format : från vision till verklighet
Andas men inte gå : dräkt med parasoll och damasker, inspirerad av Paul Poiret
Broderi och arkitektur : tre utvalda hus i broderiprocessen
Metromän - killar med koll : en studie i modern manlighet
"The Mill" : från sädesmagasin till moderna lägenheter : stämningens betydelse för inredningen i återanvända byggnader
Tygerna och kostymerna till Canadian Poems
Jag skapar själv! : kurs i kreativ tovning
Grundmönster för företaget Burfitt
Amorphus : fyra surrealistiska kollektioner
Ekobert : ett hjälpmedel för sortering av avfall på daghem
Shortcut : mönster för standardmåtten AC-D 42 156 : en bystvidd och sex stussvidder
Kafé- och universalstol i trä
Kollision : utveckling av ett vävt gardintyg med devoré-tryck, där devoré-teknikens karaktär framhävs
Gudrun : brudklänning inspirerad av vikingatiden
Mönster : planering av en serie barnmattor åt mattföretaget VM-Carpet
Laterális : en hallmöbel för trånga utrymmen
Under ytan : en serie handtryckta inredningstyger
Ikaros : kombination av grafik och möbel
Maskinbroderi på läder och mocka
Kappsäcken : att använda återvinningsmaterial med barn
Arbetskläder för restaurang Gamla Kvarnen
Bumerang : ett bord som växer med barnet
Flattop : utveckling av ett ihopfällbart datorbord och ett förvaringsskåp för datorn
Pussel : bordstextilier i dubbelvävnad
60° : analys av min designmetod samt produktutveckling av ett ljuselement
Century : en kollektion handväskor inspirerade av 1900-talet
Cella Nova : inredningsplanering av Studentföreningen vid Svenska Handelshögskolans studentkrog i Vasa
Barnens papiermaché : projekt "hantverk i skolan"
Horisontellt stapelbar stol i samarbete med Studiosalovaarat och TM-Kaluste
Husmors stolthet : hellinnehanddukar för köket
Klaff1 : ett klaffbord för båtar
En modern möbel med inspiration från 1950-talet
Scala Perfectionis : en konsttextil till Åbo Akademis Arkenkvarter
Kumbukumbu : planering av hantverksförsäljning för turister i Amani, Tanzania
Inredningsplanering av en konditionssal : i Kyrkslätts Servicecentral
Inredningsplanering av Holiday Club Katinkultas försäljningsutrymmen
Ett falskt jag : en visualisering av frågeställningen "Vad händer ifall ett barn identifierar sig med en mentalt sjuk förälder?"
Gulliver : ett arbetsbord till köket
Handledning av samma kurs åt två olika grupper
Talarstol till Skärgårdscentrum Korpoström
Ett rum i köket : planering av ett skafferi för Byggnadsapoteket Ab
Lycka, kärlek och ett långt liv : en kollektion med broderade festtoppar
Planering och tillverkning av prototyp på ställbart datorbord
Orfeus : scenkläder till en rockmusiker
Sue Ellen och Alexis : ett beställningsarbete åt fest- och brudklänningsateljén Saker & Ting
Mahogny : inredningsdetaljer för båtar och hemmet
Balans : fritidsmöbler av bra kvalitet
Hopplockbar hyllserie för hem och offentlig miljö : en vidareutvecklingsprocess av Perfect Fit
Indiska pärlan : inredning av ett avslappnings- och pausutrymme
Inuti utanpå : ett arbete om sambandet mellan klädsel och humör
Kevinpiccu design : att grunda ett företag
No strings attached : om att formge inom akustiska ramar
Glänsande koppar och skimrande silver : produktutvecklingsprocess av maskinstickade halssmycken
Omdana3 : en kollektion inspirerad av klubismen
Haka : en utvecklingsprocess av ett hyllsystem
Designprojekt : klänning till självständighetsbalen 2003
Hantverk som alternativ sysselsättningsform : en projektstudie utförd i en skyddad verkstad
Textila smycken
Sävstrået : sävens egenskaper och dess färgning
Taktilt kontra visuellt : en studie i synskadades klädvanor, samt produktion av taktila bilder
Blocks : en badrumsmöbel i värmebehandlad björk
Kostymering för teaterscenen : ett samarbete med Teater Viirus
Julia : ett tevebord med en jugeninspirerad ytdekoration
En resa till Karelen
Vecka : en kollektion damkläder inspirerade av veck
En sommarstuga i skärgården : inredningsplanering
Familjehantverk på Pargas gård : verksamhetsplan
Christer skall gifta sig! : en bröllopskostym modifierad till 2000-talet
Carnaval Fantasia : Passistas soldräkt
I min farmors fotspår ... : landsbygdskvinnors vardagskläder 1938-1953 ur Berna Kronbergs perspektiv
Att skapa välmående : en kurs i skapande verksamhet för utvecklingsstörda
Att "se" med fingrarna : handledning av synskadade barn
FIST : stol i metall för offentliga utrymmen
Brunte : två fåtöljer med sadelgjord
MySpace : en innovativ kontorsmöbel
LIILIA bröllopsgåvan
