http://www.yso.fi/onto/yso/p17597 organisationsbeteende
organisationsbeteende organisationsbeteende
Att leda på distans : i tid och rum
Identifikation med organisationen och arbetsavdelningen samt deras följder : en undersökning av ett företag i Helsingforsregionen 2005
Lokala partiorganisationer i kommunala och nationella val : förändringar i organisatorisk styrka och medlemsaktivitet i politiska lokalföreningar i Finland åren 1945-1987
Från lärandets loopar till lärande organisationer
OBM i praktiken : förändra beteenden och nå resultat i organisationer
Engagemang och styrning : om relationen individ - organisation i preklinisk läkemedelsutveckling
Den sociala desorganisationsteorin prövad : är destruktivt avvikande beteende vanligare i språkligt heterogena kommuner?
Organisationsläran : struktur och beteende
Medarbetarens organisatoriska engagemang : en fallstudie på Finlands Röda Kors
Ycdbralai : you can't do business running around like an idiot : [en bok om att arbeta mindre och få mer gjort]
Hej lättja : om konsten och vikten av att göra minsta möjliga på jobbet
Ledarskap och anställdas röst : en kvantitativ, tvärkulturell studie som jämför sambandet mellan auktoritärt och transformativt ledarskap samt anställdas röst i Finland och i Ryssland
Kommunikation för ledare
Arbetsgruppens psykologi : om den psykosociala arbetsmiljön : gruppdynamik, relationer, arbetsroller, ledarskap, konflikter, förändring och personliga olikheter
Utmanande situationer i chefsarbetet
Dynamik i arbetsgrupper : om grupprocesser på arbetet
Gruppsykologi : om grupper, organisationer och ledarskap
Industriella köpar- säljar-relationer : en analys av relationen mellan företaget Crown Products och Unicef
Människan och strukturerna : organisationsteori för förändring
Beteendet på business-to-business sektorn gällande köp på nätet
Räkna med människan : ekonomi och mänskligt beteende
Framgångsrikt ledarskap med systemteori : mönster, sammanhang och nya möjligheter
Personalgruppens psykologi : lärarhandledning
Personalgruppens psykologi
Att använda arbetsgrupper effektivt : verktyg för utveckling av lag
En mycket kortfattad, ganska intressant och någorlunda billig bok om att studera organisationer
Coaching : att hjälpa ledare och medarbetare att lyckas
Ledarskap & klokskap : konsten att få dig själv och andra att vilja
Faktorer som initierar och påverkar prat i långsiktiga relationer
Samspel : på väg till den nordiska marknaden
Ledarskap och anställdas röst : n kvantitativ, tvärkulturell studie som jämför sambandet mellan auktoritärt och transformativt ledarskap samt anställdas röst i Finland och i Ryssland
Kommunikation och konflikthantering : en introduktion
Vanans makt : varför vi gör som vi gör och hur vi kan ändra på det
Det biologiska ledarskapet
Arbetsgruppens psykologi
Grupputveckling inom skola och andra arbetsplatser
Från idé till handling : en sociologisk studie av frivilliga organisationers uppkomst och fallstudier av: Noaks Ark, 5i12-rörelsen, Farsor och morsor på stan
Inverkan av rysk kultur på OCB
Organisationsbeteende i nytt perspektiv
Coaching - att hjälpa ledare och medarbetare att lyckas
Ledarskapets grunder : organisationens hjärna
