http://www.yso.fi/onto/yso/p18105 diskussionsgrupper
diskussionsgrupper diskussionsgrupper nyhetsgrupper
Kerstin Thorvall Book Club, eller Det mest förbjudna 2.0
Herregud vilket jävla skitsnack du spyr ur dig idag : en deskriptiv studie av språkliga särdrag och ton i fyra svenska forumdiskussioner
Interaktionsmönster i arbetsgrupper : offensiva och defensiva handlingsrutiner
Deliberation och åsiktsförändring : en studie av individegenskaper och gruppkontext
Tackla hatet : om näthat och hot : och hur du skyddar dig
Skvaller : om samtalsstrategier hos kvinnor och män
Representationer av psykisk ohälsa : egna erfarenheter och dialogiskt meningsskapande i fokusgruppsamtal
Projektsamarbete : metodbok för effektiva projekt
Tolv steg för livet : Brommadialogen och kristen recovery
Unga kvinnor försvinner i staden. Kriminalinspektör Louise Hjelm får i uppdrag att lösa fallen, men hon har inga spår eller ledtrådar. Det är fler som engagerar sig. Gymnasieläraren Molly Zetterholm tar saken i egna händer när hon samlar några unga människor kring sig och genom aktioner skipar rättvisa på sitt sätt
Ungdomars argumentation : om argumentationstekniker i gruppsamtal
Några kvinnor bestämmer sig för att bilda en bokklubb i Kerstin Thorvalls namn som ett sätt att hylla författarens mod. Den första boken de läser blir Det mest förbjudna vilket leder till högljudda samtal om vad det innebär att vara medelålders kvinna och vilka förväntningar som ställs på oss. Mycket är sig likt
Avlastande samtal inom personalgrupper : handbok för samtalsledare
Bearbetande samtal : krisstöd, avlastningssamtal, stress- & konflikthantering
Massornas politiska torgmöten eller de motiverades klubbar? En studie av medborgardiskussioner på Internet
Skilda världar : en språkvetenskaplig undersökning av gruppsamtal som undervisnings- och lärandeform inom högre utbildning
Från norra ståplats till cyberspace : en beskrivning av en diskussion på internet om ishockey utifrån ett offentlighetsperspektiv
Avgrundens änglar
Sokratiska samtal i undervisningen
Kommunikation : samspel mellan människor
Chatt som umgängesform : unga skapar nätgemenskap
En fiende på Balkan : diskursanalys av ett urval artiklar om krisen i det forna Jugoslavien 1991-1993
Tjejgrupper som redskap för att stödja självkänslan hos flickor med lindrig utvecklingsstörning : en bilaga till ett arbetsmaterial
Hur leder läraren bäst ett helklassamtal? Vad betyder de instruktioner läraren ger för elevers agerande vid smågruppssamtal, och vilket socialt spel pågår mellan elever vid grupparbete? I den här boken diskuterar författaren klassrummets tal och samtal med fokus på elevers möjligheter till språkutveckling och lärande. Inte minst diskuteras frågan om vad som krävs för att elevernas förberedda tal ska bli verkligt meningsfulla inslag i undervisningen. Läsaren får ta del av både teoretisk kunskap om den muntliga kommunikationen och levande exempel ur klassrumsverkligheten. I den avslutande delen av Muntligt i klassrummet presenteras en modell för analys och bedömning av elevers muntliga presentationer. Författaren tillämpar modellen på sex autentiska elevanföranden som dels finns presenterade i boken, dels inspelade på den medföljande ljud-cd:n. Boken vänder sig till blivande och verksamma lärare i svenska och andra skolämnen på gymnasiet och i grundskolans senare årskurser.
Hotbilder : våld, aggression och religion
Massmediala samtal för alla : En studie med utgångspunkt i sms-forumet Messa Nyan om publikt deltagande i media
Språka samman : om samtal och samarbete i språkundervisning
Möjligheternas Arena? : barns och ungas samtal om tjejer, killar, känslor och sexualitet på en virtuell arena
Det värdefulla samtalet
Hägring 38 : roman
Våld mot kvinnor i parförhållanden : förhandlingar på diskussionsspalter i Internet
Yrke : skådespelare : kritiska moment i arbetslivet
Variation i webbdiskussion : en fallstudie av kontext, funktion och form i diskussionsforum om diabetes
Att leda föräldragrupper : metodik och innehåll
Muntligt i klassrummet : om tal, samtal och bedömning
Kommunikation och konflikthantering : en introduktion
Diskurspartiklar hos ungdomar i mångspråkiga miljöer i Malmö
Politiska webbdiskussioner : en studie av elektroniska diskussionsforum i en finländsk kontext
Att varsebli de berättelser vi är : en evaluering av Konst och hälsa -projektets litteraturkurs Läslust och samtalsglädje för vårdare inom äldreomsorgen med särskild hänsyn till livsberättelsen som tema
Visioner och sätt att verkställa dem : nyckelaktörers åsikter om lokal alkoholpolitik
Smutskastningen av Pro Botnia Forum : när misstänksamheten tar över
Man får kraft och stöd av dem som har det lika
Lär där du är : handbok och webbplats för distansstuderande och andra som lär på nätet
