http://www.yso.fi/onto/yso/p20694 arbetsträning
arbetsträning arbetsträning
Utveckling av team i ett IT-företag : pingisens roll i teamdynamiken
Att coacha grupper : fokusera på gruppens positiva krafter / Carina Lätt ; [illustrationer: Ranelid reklambyrå]
Metoder i arbetsträning och individuell träning: aspekter på tjänsterna i 2000-talets verkstäder
Handbok för handledning av invandrare i verkstäderna
Livbåt för ledare : en guide till coaching i företag
Affärscoachning : en integrerad samtalsmetodik i fyra steg : det är en konst att våga vara tydlig
Från chef till coach
Att återerövra vardagen : en socialpedagogisk effektstudie av ett psykosocialt rehabiliteringsprogram
Bryt ihop och kom igen! : så hanterar du motgång, konflikt och sorg med framgång
Rätten att behövas : arbetsträning för gravt förståndshandikappade på Allehandans annex
Samverkan i och med språket : systemisk-funktionell analys av språkanvändning i en kommunal gränsaktivitet med nyanlända flyktingar som målgrupp
Bli en bättre coach och mentor
Det coachande samtalets hemlighet : att hantera svåra samtal på din arbetsplats
Startträning : på väg mot livet med hjälp av konst
Kursverksamhet för kriminellt belastad ungdom
Personalens ork och motivation : en kvalitativ studie bland personal vid en social arbetsverkstad i Österbotten
Coachande ledarskap : för samarbete, effektivitet och hälsa
Träning av elever med särskilda behöv : hjälpmedel för arbets- och individuell träning
"I adoption är ingenting säkert före man får barnet i sin famn" : brukares upplevelser av den internationella adoptionsprocessen
Lärande i och för det nya arbetslivet
Grunderna i arbetsträning och individuell träning
Två och två blir fem
Kätilöopiskelijan harjoittelun työkirja = Arbetshäfte för barnmorskestuderande = Student midwifeʹs workbook
Habilitering i fokus : en människobehandlande organisation och dess utmaningar
Coachingtrappan : en handbok i att coacha och motivera till resultat
Coachande ledarskap i praktiken : propellermodellen
Det coachande samtalets hemlighet : att hantera svåra samtal på arbetsplatser
Coaching : vad - varför - hur
Starten mot ett bättre liv : grunderna i startträning
Ledarskapshandboken : att utveckla och stärka ledarskapet
Kätilöopiskelijan harjoittelun työkirja = Arbetshäfte för barnmorskestuderande = Student midwife's workbook
