http://www.yso.fi/onto/yso/p21685 musikforskning
musikforskning musikforskning
Johan Ludvig Runebergs hundraårsminne : festskrift den 5 februari 1904.
En dos musik för din hälsa : Nina Nyberg forskar i sakral körsång
Tvärspel : trettioen artiklar om musik : festskrift till Jan Ling
Fredrik Pacius, kompositör i Finland
Sprider hopp genom brutalitet
Studier över stiltrohet och subjektivitet i interpretationen av J. S. Bachs orgelkompositioner
Reflexioner, definitioner och konstruktioner : tidigare forskning om den svenskspråkiga befolkningens musikliv
Den finlandssvenska populärmusikens vara eller inte vara : diskursiva och nymaterialistiska utgångspunkter för etnicitetsinriktad musikforskning
Musiken i texten
Kommunikationens vägar : Darwin College-föreläsningarna 1989
Spelandet som musikanalytisk resurs
Natur och kulturs Musikhandbok
Om Tobias Norlind : en pionjär inom musikforskningen
Operasångerskan Emmy Achté som ikon för den finsk-nationella rörelsen
Sibelius symfonier : en studie i musikförståelse
Michael Jackson : "Dangerous" och dess mottagande
Fredrik Pacius : musiken som hemland = kotimaana musiikki
Otto Andersson och Jean Sibelius
Historiska och litteraturhistoriska studier. 87
Orglar i Finland från tiden 1600-1800 : deras byggare, historia, konstruktion och stil
Berättelsen under deras fötter : fem musiklärares livshistorier
Musik som ting : musikens materiella manifestationer i belysning av historiska instrument, fonogram och minnesböcker
Index till Musikaliska akademiens protokoll 1771-1941
Inte bara katalogregler : Festskrift till Anders Lönn 5 mars 2003
Säg det om toner och därtill i ord : musikforskare berättar om 1900-talets musikliv
Svensk rock : musik, lyrik, historik
Sprickor i fasaden : manligheter i förändring : en antologi
Musik, medier, mångkultur : förändringar i svenska musiklandskap
Bellman på Hanaholmen : nio nordiska forskare diskuterar Bellmans diktning
Let's play hockey : ishockeymusikens funktioner
Starka musikupplevelser : musik är mycket mer än bara musik
Med gårdagens dörr på glänt : Povel Ramel och melodins epok
Magdalena på källebro : en studie i finlandssvensk vistradition med utgångspunkt i visan om Maria Magdalena
Apropå Jan Ling : elva texter om musikforskning och musikliv : presenterade vid ett symposium till Jan Lings minne den 8 april 2014 på Kungl. Musikaliska akademien
Sibelius symfonier : En studie i musikförståelse
Den gemensamma tonen : föredrag från seminariet Det gemensamma rikets musikskatter på Hanaholmen, kulturcentrum för Sverige och Finland : Esbo den 2.-4. december 1988
Hufvuddragen af den västerländska musikens historia från den kristna tidens början till våra dagar
Klassläraren som musikpedagog. : Musikalisk bakgrund, arbetssituation och innehållsmässiga prioriteringar
Musikvetenskap : en översikt
Från bondson till folkmusikikon : Otto Andersson och formandet av "finlandssvensk folkmusik"
Wagner och vår tid : Essäen - Betraktelser - Brev
Musikliv : vad människor gör med musik - och musik med människor
Fröding och musiken : Några aspekter
Musiklivet i det gamla Viborg - en Östersjöangelägenhet
Musikforum : aktuellt om musik i forskning, undervisning och samhälle
Det där lät ju dåligt. Vad synd. : en studie av instrumentlärarens musikpedagogiska grundsyn i det finländska musikinstitutet
För resandets skull : i diktares sällskap vid franska floder
Lucias vansinne på finska : Emmy Achtés debut i Lucia Lammermoorin morsian på Finska Operan år 1873.
