http://www.yso.fi/onto/yso/p23336 landskapshistoria
landskapshistoria landskapshistoria
Skånska godsmiljöer
Båthuset : i svenska och finska skärgårdar
Friluftsmåleriets genombrott i svensk konst 1860 -1885
Arkitektur för livet : om nutidens arkitektur mellan dåtid och framtid
Kungliga Djurgården : en kulturhistorisk vandring med Jan Mårtenson
Bymarker i backspegel : odlinglandskapet före kartornas tid
Periferins landskap : historiska spår och nutida blickfält i svensk glesbygd
Centraliteter : människor, strategier och landskap
Mylla mule människa : det västgötska kulturlandskapet, några brottstycken
Det formade landskapet : en studie i markanvändningen i Kvarnby, Kyrkslätt mellan åren 1781-1901 och i Saaris, Mietois mellan åren 1693-1887
Spår
Att gräva agrarhistoriska lämningar : rapport från ett seminarium i Lund 27-28 januari 1998
Slåttergubbar och liemän : om odlingslandskapet i förändring
Det sydsvenska kulturlandskapets förändringar under 6000 år : Ystadsprojektet : en utställning on människan och miljön ur ett tvärvetenskapligt perspektiv
Iter Lapponicum = Lappländska resan, 1732. 3, Facsimileutgåva
Ekoparken : nationalstadsparken Ulriksdal - Haga-Brunnsviken - Djurgården
Kulturlandskapsförändring och samhällsutveckling : en undersökning av rumsliga förändringar av kulturlandskapet i Torstuna socken i Uppland från 0 till 1650
Öresundsförbindelsen : Naffentorp 5A : rapport över arkeologisk slutundersökning
"En natur för män att grubbla i" : individualitet och officialitet i varbergskolonins landskapsmåleri
Suomalainen maisema : maisemantutkimuksen näkökulmia = Det finländska landskapet : olika synvinklar inom landskapsforskningen = The Finnish landscape : perspectives on landscape research
Landet som skapade Rom : en humanekologisk historia
Landskap bortom traditionen : historisk arkeologi i nordvästra Skåne
Det agrara landskapets pris
Ålands kulturlandskap 1700-talet
Iter Lapponicum = Lappländska resan, 1732. 1, Dagboken
Gamla vykort från Umeå : en bildsvit med text
Det maritima kulturlandskapet kring Bottenviken : artiklar och studier från Bottenviksprojektet
Svenska byar utan systematisk reglering : en jämförande historisk undersökning utarbetad med stöd av Nordiska museet och Samfundet för svensk folklivsforskning. [1]
Att skapa plats och göra rum : landskapsperspektiv på det historiska värdets betydelse och funktion i svensk planering och miljövård
Thure Georg Sundell : ett gåtfullt konstnärsöde med synpunkter för pedagogiskt bruk
Trädgårdsideal och kunskapssyn : en studie av meningens uttryck med exempel från Gösta Reuterswärds och Ulla Molins skapande handling
Svensk historisk bibliografi: Med bidrag av tre arkeologer, tre ekologer, två historiker, två ekonom-historiker, en socialantropolog, en etnolog, en biolog och en kulturgeograf.
Kulturmiljövård i skogen : att känna och bevara våra kulturminnen
Naturens spegel : nordiskt landskapsmåleri 1840-1910
Bebyggelsehistorisk tidskrift. Nr. 38, (1999), Natur som kultur
Äldre tiders odling : trädgårdsväxter, gamla grödor och ogräs : nordiskt seminarium, 9-11 november 1994
Kyrkan i landskapet
Gårdar och gärdesgårdar i Markim
Kulturhistoriska miljöer i Borgå landskommun
Park & trädgård i kulturarvsperspektiv : dokumentation från temadagen Trädgårdar & parker, historia & förvaltning, Avdelningen för kulturvård, Göteborgs universitet, november 2000
På edra platser
Kulturlandskap och bebyggelsehistoria : kring ett forskningsfält med exempel från forntid och medeltid
Öland och världsarvet
Arkeologi i Östergötland : scener ur ett landskaps förhistoria
Kyrkogårdens gröna kulturarv
Hembygd Halland : flygfotografier och vykort från 1930-talet
Imatra som natursevärdhet till och med 1870 : en reselitterär undersökning med lokalhistorisk begränsning
Referat : Östergötland 1982 : förbundets 26:e möte i Vadstena 1982 : program, föredrag, referat, sammanfattningar, plenarmöte och deltagareförteckning
Teckningar till Svecia antiqua et hodierna. 3, Svealands återstod, Norrland och Åland
Visby : landet utanför muren
Barknåre by : markanvändning och bebyggelse i en uppländsk by under tusen år
Bebyggelsehistorisk tidskrift. Nr. 49, 2005, Från slott occh koja
Nya anteckningar om Rytterns socken : medeltidsstudier tillägnade Göran Dahlbäck
Svenska byar utan systematisk reglering : en jämförande historisk undersökning. [2], Kartor
Mälarbygd : agrar bebyggelse och odling ur ett historisk-geografiskt perspektiv
Fornlämningar och bebyggelsehistoria
Guide till svensk landskapsarkitektur
Stockholmsgårdar
Malaxbygden : bebyggelse och hushållning i södra delen av Österbottens svenskbygd : en studie i människans och näringslivets geografi
Östersjöns skeppssättningar : monument och mötesplatser under yngre bronsålder
Skog : landskap och minne : en civilisationshistoria
Nordisk bergshantering : människor, landskap och bebyggelse : bergshanteringens bevarandefrågor i ett nordiskt perspektiv : rapport från en nordisk konferens i Sandviken den 18-21 oktober 1982.
Mark i marginalen : drivkrafter, pionjärer och myrodlingslandskap
Laponia : Lapplands världsarv : ett natur- och kulturarv att förvaltas för framtiden
Parker, trädgårdar, landskap : förnya och bevara
Landskapsbilden : ur den europeiska naturkänslans historia
Herrön : levande odlingslandskap
Vad berättar en by? : om äldre kulturmiljösystem i odlingslandskapet
Uppland från ovan och i mina minnen
Ekologi, kulturlandskapsutveckling och bebyggelsehistoria : Uppsalasymposiet 1973.
Landskapsutveckling i Norra Värmlands finnbygder : en studie av landskaps- och floraförändringar = Landscape formation in the Finnish settlement in Northern Värmland : a study of the change in the landscape and the flora
Markens minnen : landskap och odlingshistoria på småländska höglandet under 6000 år
Odlingslandskapet : en lång markanvändnings historia
Periferin i Europas mitt : kulturarv, minnen och stadsmiljö i Västukraina och Moldavien
Parker i Umeå och Vasa
Läsa landskap : en fälthandbok om svenska kulturmiljöer
Landskapsspejare
Gårdsgärdor och tegskiftesåker : Resursutnyttjande och kulturellt inflytande i det gamla landskapet Västerbotten
