http://www.yso.fi/onto/yso/p24876 Nuori Kulttuuri
Nuori Kulttuuri Nuori Kulttuuri
Till varje pris : några definitioner, påståenden och tankar om kommersialism - ett debattmaterial
Har biblioteket glömt tonåringarna? : sju inlägg om samverkan bibliotek-fritidsgårdar-föreningsliv
En ung mans memoarer
På jakt efter litteraturens väsen
AlieNation is my nation : hiphop och unga mäns utanförskap i Det nya Sverige
Ungdomars barkultur i Borgå
Pengarna eller livet
Kvinnor och etnicitet
Spelrum : om lek, stil och flyt i ungdomskulturen
Speciellt för speciella? : rapport om funktionshindrade barns och ungdomars tillgång till och delaktighet i kultur
Ungdomskulturen och de andra : sex essäer om ungdom, identitet och modernitet
Ungdomars utnyttjande av och attityder till kulturtjänster : Case: Vasa kulturcenter
Känslan för platser : en jämförande utvecklingspsykologisk studie av barns och ungdomars värdering av fysisk miljö i Sverige och Frankrike. D. 1, Landsbygdsbarn
Ungdomskultur: identitet och motstånd
Ungdomskultur, stil och smak
Tecken i tiden : sju texter om ungdomskultur
Sammendrag. - Summary. - Tiivistelmä. - Ágrip.
Fristadens barn : om ungdomars livsstilar, kulturer och framtidsperspektiv i 80-talets Sverige
Att vara mitt emellan : hur spanskamerikanska ungdomar i Sverige kan uppfatta villkoren för sin sociokulturella identitetsutveckling
Ungdomsarbete är nödvändigt : teoretisk underbyggnad, metodernas begränsningar och möjligheter
Ungdom, kulturmöten, identitet
Från djäkne till swingpjatt : om de moderna ungdomskulturernas historia
Kundens responsbenägenhet : en jämförelse inom restaurangbranschen mellan svensk- och finskspråkiga kunder
Att förstå ungdom : identitet och mening i en föränderlig värld
Växa upp med musik : ungdomars musikanvändande i skolan och på fritiden
Ungdom som samhällsproblem
Datorspelande som bildning och kultur : en hermeneutisk studie av datorspelande
Ungdomskulturer - äger eller suger? : möjliga möten inom svenskämnet
Dansminnen : ungdomsdanserna i Österbotten och Västerbotten från 1940-tal till 1970-tal
Ungdomskulturen i Öst- och Sydöstasien
Ungdomsforskning : kritik, reflektioner och framtida möjligheter
Kön och identitet i förändring
Generation efter generation : om tonårskultur, ungdomsrevolt och generationsmotsättningar
Sveriges oälskade barn : att vara svensk men ändå inte
Om unga män : identitet, kultur och livsvillkor
Sexualitetens omvandlingar : politisk lesbiskhet, unga kristna och machokulturer
Våldet mot ögat : filmforskare om film- och videoskräck
Skola - fritid - framtid : en studie av ungdomars kulturmönster och livschanser
Kulturanalyser : ungdom, utbildning, modernitet : essäer sammanställda av Johan Fornäs och Joachim Retzlaff i samarbete med författaren
Att resa över tid och rum : metodguide om tidsresor och kulturarvspedagogik
Växa med kultur : om kulturprojekt för barn och ungdom
Olika men ändå lika : om invandrarungdomar i det mångkulturella Sverige : betänkande
Ungdom i nya kläder : dansbanefröjder och längtan efter det moderna i 1940-talets Sverige
Ungdomskultur : identitet och motstånd
Nytt land och ny skola : berättelser om att bryta upp och börja om
Punkare och skinheads : socialisering i gäng
Halim går på högstadiet och har nyligen flyttat från Skärholmen till Söder där han nu bor ensam med sin pappa. Halim drömmer om att bli en tankesultan och om att återupprätta alla blattars heder. Skriven på Rinkebysvenska.
Högt & lågt : smak och stil i ungdomskulturen
Mardrömmar och önskedrömmar : om ungdom och ungdomlighet i nittiotalets Sverige
Ungdomar i skilda sfärer
Modernitet, adolescens & kulturella uttryck
Ungdomstid
Ungdom fritid kultur : en bok om ungdoms- och fritidsgårdar
Generation Ego : att fostras i en narcissistisk kultur
Rummet som plats : en jämförande utvecklingspsykologisk studie av barns och ungdomars värdering av fysisk miljö i Sverige och Frankrike. D. 2, Stadsbarn
Från klubbrum till medielabyrint : ungdomsprogram i radio och TV 1925-1993
Från flygdröm till swingscen : ungdom och modernitet på 1930-talet
Ung i Malmö : 1950-1979
Unga kvinnor
Ungdomsbilder : text och kontext i den norrbottniska mediediskursen från trettiotal till åttiotal
Nu dyker jag! : ett hopp in i seriernas okända vatten
Dansbaneeländet : ungdomen, populärkulturen och opinionen
Solo : bara för dig
Att vara ung : mellan cafébesök och traditionella kunskaper : projektrapport = To be young : between café visits and traditional knowledge : project report
Ungdom och kulturell modernisering
Av drömmar väver man... : ungdomskultur, socialisation, ungdomsarbete
Speglad ungdom : forskningsreception i tre rockband
Finlandsvenska niondeklassares historiekultur 2012
Kulturutbud för döva barn och ungdomar
Metodfrågor i ungdomskulturforskningen
Ungdomsgrupper i teori och praktik
Ungdom i gränsland
Under rocken : musikens roll i tre unga band
Ungdom och tradition : en etnologisk syn på mångkulturell uppväxt
Unga stilar och uttrycksformer
Sen' kommer en annan tid : en antologi om barns och ungdomars livsformer
Den upproriska skötsamheten : att vara ung och scout
Bilder och självbilder : en studie om identitetsförhandlingar bland finlandsvenska ungdomar
Från Elvis till Emo : ungdomskulturer 1950-2010
