http://www.yso.fi/onto/yso/p27571 filmforskning
filmforskning filmforskning
As above, so below
Förtätade filmögonblick : den rörliga bildens förmåga att beröra
Inledning till filmstudier : Historia, teori och analys
Sidor av samma sak? : sex uppsatser om översättning
Det finländska på vita duken
Spelar kön någon roll när man räddar världen? : kvinnor, kvinnligheter och messiasmyter i SF-film
Politik och film
Sociala konflikter och kulturella processer : historia med människor i centrum
Populärt berättande och offentlighet : sujet, excess, den sociala detektiven och den privata familjen
Rödluvan i filmens tidsålder : sagospår och filmversioner 1901-2001
Boatcenters Marknadsföringsvideo
Medvetet/omedvetet och filmberättande : en studie i Akira Kurosawas film Sju samurajer
Barn, böcker och massmedier
Stockholm cinema studies
Filmstilar från Méliès till Truffaut : en antologi
Skräck som fiktion och underhållning
Film och historia : historisk Hollywoodfilm 1960-2000
Ihmiskunnan herääminen = Humanity ascending. Part 1 : Our story
Klasskamp och kultur : för en marxistisk kultursyn
Den nya svenska filmen : kultur, kriminalitet & kakafoni
Saaristomeren biosfäärialue : Saaristomeren biosfäärialueseminaari Turun yliopistossa 11.11.1993 : tiivistelmät = Skärgårdshavets biosfärområde : ett seminarium om Skärgårdshavets biosfärområde i Åbo universitet 11.11.1993 : sammanfattningar
Kritisk läsning och ärliga ord : vänskrift till Siv Illman
Svensk filmforskning
Fredrik Pacius : musiken som hemland = kotimaana musiikki
Krapula : Henry Parland och romanprojektet Sönder
Filmbytare : videovåld, kulturell produktion & unga män
I gränslandet : nya perspektiv på film och modernism
Harens almanacka : essäer om poesi och tid
Skjorta eller själ? : kulturella identiteter i tid och rum
Bilder från Bergman : essäer
Mångfald i medieforskningen : symposium, Malmö högskola 24-25 april 2002
De mörka labyrinterna : gotiken i litteratur, film, musik och rollspel
Filmanalys : en introduktion
Våldsamma fantasier : studier i fiktionsvåldets funktion och attraktion
XXI Nordiska historikermötet, Umeå 1991. Huvudtema 1, Icke skriftliga källor
Sammandrag: Mot natten i Helsingfors.
Kriminallitteratur : utveckling, genrer, perspektiv
Snuten i skymningslandet : svenska polisberättelser i roman och på film 1965-2010
Mimetiskt syskonskap : en representationsteoretisk undersökning av relationen fiktionsprosa-fiktionsfilm
Ondska - individuell och kulturell projektion : filmupplevelser analyserade enligt den analytiska psykologin
Det omvända anletet : Mikael Enckell
Runar Schildts roller : föreläsningar hållna under Schildt-symposiet i Lovisa den 2-3 juni 1988
Utanför tiden : självbiografiska essäer
Invandrarsvenska i filmer
Litterära resor : turism i spåren efter böcker, filmer och författare
Essäfilmen : försök till en karakteristisk
Filmboken : analys, filmhistoria, praktiska övningar
Flumen saxosum sonans : studia in honorem Gunnar af Hällström
Robin Wood - brittisk filmkritiker
Kvinnor och messiasgestalter i science fiction-film
Essäfilmen : försök till en karakteristik
Sex, våld och perversioner : en queerteoretisk syn på marginalfilmer
Att konstruera en kvinna : berättelser om normer, flickor och tanter
Perspektiv på Fröken Julie : dokument och studier
Levande röster på två rader : persondifferentiering i interlingval textning
Metod och minne : etnologiska tolkningar och rekonstruktioner
Konst och antikonst
I nattens korridorer : artiklar om skräck och mörk fantasy
Film : [historia, regissörer från A till Ö, genrer, de 100 bästa filmerna]
