http://www.yso.fi/onto/yso/p27553 filmhistoria
filmhistoria filmhistoria filmens historia
Filmboken
En kronologisk översikt om trailerns utveckling under senaste centennium : Samt en fallstudie av trailern till filmen Paniikkipäiväkirjat
Inledning till filmstudier : Historia, teori och analys
Bildspråkets betydelser : ett bidrag till filmteorins historia
Svensk spelfilm under andra världskriget
Filmkultur och nöjesliv i Örebro 1897-1908
Svenska biografer
Svensk film och visuell masskultur 1900
Film och andra rörliga bilder : en introduktion
Folkbildning, företag, propaganda : den finska icke-fiktiva filmen på det fält där nationellt symbolgods skapades under mellankrigstiden
Filmens värld : sjuttio års filmhistoria
Förtätade bilder : filmens närbilder i historisk och teoretisk belysning
Dramats historia : filmkunskap
Fakta om film
Ungdom i fara : ungdomsproblem i svensk spelfilm 1942-62
Stop motion i filmiskt berättande
Naapuri elävissä kuvissa : Suomeen tuodut, vuosina 1910-1940 valmistetut ruotsinmaalaiset elokuvat = åren 1910-1940 producerade svenska långfilmer, som importerats till Finland
Tintins äventyr - Enhörningens hemlighet : boken om filmen
Pojken med de stora ögonen : Stanley Kubrick och hans filmer
Medvetet/omedvetet och filmberättande : en studie i Akira Kurosawas film Sju samurajer
Hundra spelår : år för år : från 90-tal till 90-tal i svensk teater och film
Film i går, idag, i morgon
Fredrik den store och Karl XII som stumfilmshjältar : produktion och reception av filmerna Fridericus Rex och Karl XII
Lindsay Anderson och filmens estetik
Äventyr i filmbranschen : om entreprenörerna John Johansson och John Ek från Jönköping, deras biografer, distribution och filmproduktion samt nedslag i Jönköpings film- och biografliv 1897-2002
Film och historia : historisk Hollywoodfilm 1960-2000
Fanny och Alexander : ur Ingmar Bergmans arkiv och hemliga gömmor
I offentlighetens ljus : stumfilmens affischer, kritiker, stjärnor och musik
Fucking film : den nya svenska filmen
Vissa visioner : tendenser i svensk biografdistribuerad fiktionsfilm 1967-1972
Studio. 6, Ensiesitysteattereiden ohjelmisto Helsingissä vuonna 1960 : Premiärbiografernas repertoar i Helsingfors 1960
Upplevelser av svensk film : en kartläggning av genrer inom svensk film under åren 1985-2000
Folklighetsfabriken : porträtt av ett svenskt filmbolag
Film på finlandssvenska : från Stiller till Engström
Den svenska filmens historia
Våra gossar på vita duken : bilden av det självständiga Finlands armé och dess soldater i inhemska spelfilmer före andra världskriget
Filmen i Sverige : en historia i tio kapitel
Från skapelsen till Edvard Persson : "Fem essäer om film" omarbetade och ytterligare tre
Svensk filmforskning
Tystnad! Tagning! : en bok om Värmland i filmen
Kameran går
Svensk sensationsfilm : en ocensurerad guide till den fördolda svenska filmhistorien, 1951-1993
Mitt personregister. Urval 98, "-in i filmateljén"
Den glömde mannen : Erik "Hampe" Faustmans filmer
Stumfilmen i Sverige - kritik och debatt : Hur samtiden värderade den nya konstarten
Den nationella stilen : studier i den svenska filmens guldålder
Rapport från en kulturell korsväg : schweizisk film nu och då
Franska bilder : filmens födelse till Nya vågen
Filmstaden 1919-2000
Star wars ljussablar : en guide till kraftens vapen
Tabu : filmaren Vilgot Sjöman
I teatralitetens brännvidd : om Ingmar Bergmans filmkonst
Kvinnors ansikte : stereotyper och kvinnlig identitet i trettiotalets svenska filmmelodram
Göteborgs alla biografer : en resa i 100 år
Amerikanism, bolsjevism och korta kjolar : filmen och dess publik i Sverige under 1920-talet
Staten och filmen : svensk filmpolitik 1909-1993
Filmens historia : de första hundra åren från zoopraxiscope till video. D. 1, Pionjäråren
Att synliggöra det dolda : om fyra svenska kvinnors filmregi
1001 filmer du måste se innan du dör
Filmens historia : de första hundra åren från zoopraxiscope till video. Del 3, Förändringens vind [1940-1990]
K. E. Ståhlberg : fotograf, filmskapare och entreprenör
Brittiska fiktioner : intermediala studier i film, TV, dramatik, prosa och poesi
Folkhemmets skuggbilder : en kulturanalytisk genrestudie av svensk kriminalfiktion i film och TV
Kampen om verkligheten : Stefan Jarls Modstrilogi ur ett historiskt och teoretiskt perspektiv
Filmboken : analys, filmhistoria, praktiska övningar
På bio söder om Sahara : en bok om filmen i det svarta Afrika
Bilden av förintelsen : handledning för att se, analysera och diskutera filmer om nazism och motståndskamp
Så föddes filmen : ett massmediums uppkomst och genombrott
Peter Weiss filmer : från de korta små lekfulla kopparslagen till kommersiell långfilmsdebut : filmer - filmidéer - utkast
Det pensionerade paradiset
Sex, våld och perversioner : en queerteoretisk syn på marginalfilmer
Flammande vildmark : essäer om film
Filmens historia : de första hundra åren från zoopraxiscope till video. D. 2, Guldålder
Vithet i svensk spelfilm 1989-2010
Dramatik på vita duken : anteckningar kring den svenska filmen och dess relation till författarna 1910-1990
Tusen och en tolkning - samt en andalusisk hund
Clio på bio : om amerikansk film, historia och identitet
En fiende till civilisationen : manlighet, genusrelationer, sexualitet och rasstereotyper i svensk filmkultur under 1920-talet
Filmen 100 år : några glimtar ur de rörliga bildernas historia
Filmbilar : från Smultronstället till Vägens djävlar
På filmens vingar : flygfilmens historia i ord och bild
Motbilder : svensk socialistisk filmkritik : en antologi
Svenska stjärnor : från filmens och scenens värld
Bevara dokumentärfilmens kulturarv : åtgärdsförslag samt förslag till ett centrum för dokumentärfilm och en filmvårdscentral : betänkande
Film : [historia, regissörer från A till Ö, genrer, de 100 bästa filmerna]
