http://www.yso.fi/onto/yso/p28251 gruppundervisning
gruppundervisning gruppundervisning
Leka i grupp : lekmetodik för barn i förskola, skola och fritidshem
Etnicitet som resurs : i skolan
Pedagogikens tango : om individen, gruppen, tänkande och lärande
Grupparbete och individualisering
Arbete i lag och grupp : om grupparbete, tema, projekt och lärarlag i skola och undervisning
Problembaserat lärande : idén, handledaren och gruppen
Att förädla information till kunskap : lärande och klassrumsarbete i mediesamhället
Dynamic pedagogy - communication and creativity in education = Dynamisk pedagogik - kommunikation och kreativitet i undervisning. Guide : Sweden
Boken som läser mig : en handbok för bibelstudieledare
Programmerad undervisning, språklaboratorier och gruppdynamisk kartläggning : några hjälpmedel vid differentiering inom klassens ram
Att lära i samarbete : samarbetsinlärning i teori och praktik
Samarbetsinlärning
Grupparbetets metodik
Rollspel i teori och praktik
Barnomsorgen är för alla barn : förskole- och fritidshemsverksamhet för barn som behöver särskilt st
Fungerande kommunikation garanterar trivsel i Kronoby
Klasstorleken bör minskas
Muntligt i klassrummet : om tal, samtal och bedömning
"Pysäytyykö tämä bussi centrumista?" : En fallstudie om den språkliga vardagen hos svenskspråkiga finlandssvenska ungdomar i Helsingfors
Heterogeniteten i svenska inom yrkesutbildningen på andra stadiet
Skolklassens storlek och struktur : studier rörande elevernas kunskaper i relation till klassens storlek och homogenitet
Topikövergång i textbaserade gruppsamtal
Lärares och elevers interaktion i klassrummet : betydelsen av kön, ålder, ämne och klasstorlek samt lärares uppfattningar om interaktionen
Utbildningssegregation och självsortering : om gymnasieval, genus och lokala praktiker
Lärgemenskaper på nätet : en introduktion
Handbok för grupparbete : att skapa fungerande grupparbeten i undervisning
Röster i samspel : analys av gymnasieelevers radioprogram
Åldersindelat eller åldersblandat? : forskning om ålderssammansättningens betydelse i förskola och grundskola
Dynamisk pedagogik : synpunkter på skapande verksamhet samt samspel och samarbete i grupp
Det sociala livet i skolan : socialpsykologi för lärare
Klasstandem : en resa över språkgränsen = Luokkatandem : matka yli kielirajan
Att lära sig muntlig kommunikation genom smågruppsarbete : ett materialpaket för svenska som B1-språk för årskurs 6
Att leva och lära i grupp : om mål och arbetssätt i förskolan
Att lära i samarbete : grupparbete i förskola och skola
Dialogpedagogik och motivation : en fallstudie i svenska på universitetsnivå
Arbete i lag och grupp : om grupparbete, tema, projekt, lärarlag och lokala arbetsplaner i skola och undervisning
Barns kamratrelationer i förskolan : samhörighet, tillhörighet, vänskap, utanförskap
Perspektiv på barndom och barns lärande : en kunskapsöversikt om lärande i förskolan och grundskolans tidigare år : kunskapsöversikt
Biblioteket i världen : en inspirationsbok
Grupphandledning : den lilla gruppen som forum för lärande
En för alla : en studie i kooperativ inlärning
Att studera problem : tio exempel på projektarbete vid universitet, högskolor, folkhögskolor
Skriva för att lära : skrivande i högre utbildning
Lär där du är : handbok och webbplats för distansstuderande och andra som lär på nätet
Du har huvudrollen i ditt liv : om forumspel som pedagogisk metod för frigörelse och förändring
Förskolemetodik : en grundbok
Programmerad undervisning språklaboratorien och gruppdynamisk kartläggning : några hjälpmedel vid differentiering inom klassens ram
Möten för lärande : pedagogisk verksamhet för de yngsta barnen i förskolan
Hur ordnar vi för Mirja, Mile, Marco? : om stödundervisning och andra åtgärder till hjälp för invandrarbarn
Pedagogiskt drama : metodanalyser
Gruppmentorskap som stöd för lärares professionella utveckling
Hur leder läraren bäst ett helklassamtal? Vad betyder de instruktioner läraren ger för elevers agerande vid smågruppssamtal, och vilket socialt spel pågår mellan elever vid grupparbete? I den här boken diskuterar författaren klassrummets tal och samtal med fokus på elevers möjligheter till språkutveckling och lärande. Inte minst diskuteras frågan om vad som krävs för att elevernas förberedda tal ska bli verkligt meningsfulla inslag i undervisningen. Läsaren får ta del av både teoretisk kunskap om den muntliga kommunikationen och levande exempel ur klassrumsverkligheten. I den avslutande delen av Muntligt i klassrummet presenteras en modell för analys och bedömning av elevers muntliga presentationer. Författaren tillämpar modellen på sex autentiska elevanföranden som dels finns presenterade i boken, dels inspelade på den medföljande ljud-cd:n. Boken vänder sig till blivande och verksamma lärare i svenska och andra skolämnen på gymnasiet och i grundskolans senare årskurser.
Gem-engelska : slutrapport från engelskdelen av projektet Grupperingsfrågor i engelska och matematik på grundskolans högstadium
Kommunikation och inlärning
Anpassad gymnastikundervisning : en handledning i gymnastik för handikappade och långvarigt sjuka barn
Flow i simulatorstödd läromiljöö
Specialklassen i livet : en utredning över erfarenheter av utbildning och arbete hos unga vuxna handikappade, till den romska befolkningen hörande eller med invandrarbakgrund vilka studerat i specialklass i grundskolan.
Samspel i grupp
Åldersblandade klasser : lärares föreställningar och elevers erfarenheter
Hur man effektiverar språkinlärning : utkast till en lektion
Språkpolitiskt program för teckenspråken i Finland
Problembaserad inlärning (PBI) inom grundskollärarutbildningen : uppfattningar hos lärarstuderande om kunskapens villkor och karaktär samt om utbildningens utformning
PBL och undervisningsteknologi hand i hand med traditionella föreläsningar? : utvärdering av ett försöksprojekt i socialpsykologi och psykologi
På väg mot social gemenskap : synpunkter på utbildningens och den etniska tillhörighetens landskap
Vi arbetar tillsammans : grupparbete med biblioteksövningar
Fjolårets nya term timresurs: diskuteras med förväntan men även förbehållsamhet
Vuxna lär : förutsättningar och metoder i vuxenundervisningen : vuxenpedagogiska seminariet vid Stockholms universitet under ledning av Torsten Húsen
Skilda världar : en språkvetenskaplig undersökning av gruppsamtal som undervisnings- och lärandeform inom högre utbildning
Ett steg i sänder : en kommunikationsmodell inspirerad av Sherbornes Relation Play vid autism och andra kommunikationsstörningar
Sokratiska samtal i undervisningen
Social kompetens i förskolan : att bygga broar mellan teori och praktik
Språka samman : om samtal och samarbete i språkundervisning
Våga vara i skolan
Kläcker flera hjärnor bättre idéer? Om gymnasisternas attityder till grupp- och pararbete i svenskundervisningen
Skolan är en plats där barn, ungdomar och personal med olika etnisk bakgrund möts. Men vad är etnicitet? Hur kommer det till uttryck, hur uppstår det och varför tillskrivs det "invandrare" men sällan "svenskar"? Layal Kasselias Wiltgrens bok, som baseras på en årslång fältstudie på en förortsskola, är angelägen för alla som arbetar med barn och unga i Sverige idag. Här erbjuds en behövlig och begriplig teoretisk grund till hur och varför vi ska möta elever som individer snarare än som representanter för ett kön, en bostadsort eller en etnisk grupp. Boken lyfter fram de positiva resurser eleverna bär med sig och vilka möjligheter det finns att stärka ungdomarna ytterligare. Författaren uppmärksammar att etniciteter är komplexa. En person kan beskriva sig själv som irakier, kaldé, arab och svensk vid olika tillfällen. Stereotypa uppfattningar begränsar därför eleverna. Det gäller att skapa ett utökat handlingsutrymme för ungdomarna, vilket är en viktig del av värdegrundsarbetet.
Grupprocesser i utbildning : en studie av gruppers dynamik vid problembaserat lärande
Coaching och handledning av grupper : inom universitets- och högskoleutbildning
Nordtest 1989 : textkompendium för inträdesprovet i nordisk filologi
Vi är ju alla här för att sjunga bättre och utvecklas : en intervjustudie om upplevelser av gruppundervisning i pop/jazz-sång
Finlands historia : lätläst
