http://www.yso.fi/onto/yso/p4079 grupparbete
grupparbete grupparbete
Tillsammans kan vi lära och förändra : deltagardriven forskning för svenskt lantbruk
Effektiva arbetslag i skolan : tankar, idéer, verktyg
Funktionshindrade kvinnors empowerment och livskraft : redovisning av Deep-projektet Disabled women's empowerment and energy project "Peer support" inom EU:s Socrates-program
Klara dina studier! : handbok för studenter på universitet och högskola
Projektsamarbete : metodbok för effektiva projekt
Opera : en guide för effektivare arbetsmöten
Projekt är människor : hur du driver framgångsrika projekt genom att skapa goda relationer i projektgruppen
Problembaserat lärande : idén, handledaren och gruppen
Grupper : att leda små grupper inom hälso- och sjukvård
Teamet : utveckling, effektivitet och förändring i grupper
Dynamik i arbetsgrupper : om grupprocesser på arbetet
Jobba på din kompetens : gruppmetoden : arbetsbok
Elevers interaktiva lärande vid problemlösning i grupp : en processtudie
Samarbetsinlärning
Arbetsgrupper : från gränslösa team till slutna rum
Styrkebaserad teamutveckling : en praktisk handbok i Appreciative inquiry : Hur kan vi använda värdeskapande frågor och locka fram det bästa i dig, i andra och i varje situation?
Reteaming : att lyckas tillsammans : utvecklingsprogram för arbetsgrupper
Rollspel i teori och praktik
Praktisk ledning av förbättringsprocesser : inriktad på samverkan mellan resultat, process och team
Fungerande kommunikation garanterar trivsel i Kronoby
Nya Att leda team : hur man engagerar och inspirerar team
Vingar som bär : ett killgruppsmaterial
Metoder för framtidsdiskussion : i grupp
Föreställningar om grupper
Samarbetets psykologi : experimentella och teoretiska bidrag
Samspel i grupp : introduktion till gruppdynamik
OPERA : ett verktyg för effektiva arbetsmöten
Handbok för grupparbete : att skapa fungerande grupparbeten i undervisning
Processens problematik och problemens processer : en fallstudie om ett bibelöversättningsteams arbetsprocess, översättningsproblem och strategier
Äventyrspedagogik som samarbetsbefrämjande metod
Individer, grupper och ledarskap i projekt
Utveckla teamet : en bok om gruppers utveckling
Nya effektiva arbetsteam : synliggörande pedagogik i teambuilding och personlig utveckling
Växelverkan - interaktion i grupp : fickbok
Att lära sig muntlig kommunikation genom smågruppsarbete : ett materialpaket för svenska som B1-språk för årskurs 6
Projektkommunikation : så får du den att fungera!
Arbeta i projekt : individen, gruppen, ledaren
Ledaren, individen, gruppen : så skapar du effektiva team
Att lära i samarbete : grupparbete i förskola och skola
Arbete i lag och grupp : om grupparbete, tema, projekt, lärarlag och lokala arbetsplaner i skola och undervisning
Gruppsykologi : om grupper, organisationer och ledarskap
Studieteknik för effektiva studier
Utvecklingssamtal i grupp
Att effektivera projektarbete : Utvecklingsförslag för Ålands Sjödagars projektgrupp 2014
Individ och grupp : en introduktion till gruppsykologi
Inneslutandets och uteslutandets praktik : en studie av barns relationsarbete i skolan
Samling i förskolan
Distribuerad arbetsgrupp som arbetsplats
Team work : medel för morgondagens skola?
Individ och grupp
Gruppdynamik i teori och praktik : övningar och kommentarer
Grupphandledning : den lilla gruppen som forum för lärande
En för alla : en studie i kooperativ inlärning
Nya team i organisationernas värld
Insyn i grupphandledning : ett bidrag till förståelsen av ett av de människobehandlande yrkenas hjälpredskap
Ledaren på den inre scenen : psykoanalytiska perspektiv på grupper och ledarskap
Terveydenhuollon ammattihenkilöt 31.12.2003 = Yrkesutbildade personer inom hälso- och sjukvården 31.12.2003
Skriva för att lära : skrivande i högre utbildning
Grupprocesser : om inlärning och samarbete i grupper
Att coacha grupper : fokusera på gruppens positiva krafter / Carina Lätt ; [illustrationer: Ranelid reklambyrå]
Moderna lagarbeten : studier av arbete, teknik och organisation i högteknologisk processindustri
Samtalsgrupper : teori och praktik
Ledarskap i förskolan
Vi gör det tillsammans : handbok om samarbete
Förskolemetodik : en grundbok
Temaarbete : lärarens metodik och barnens förståelse
Programmerad undervisning språklaboratorien och gruppdynamisk kartläggning : några hjälpmedel vid differentiering inom klassens ram
Att arbeta med barngrupp
Ett steg närmare nya psalmer
Att leda team : hur man engagerar och inspirerar team
Pedagogiskt drama : metodanalyser
Det kreativa mötet
Bilda och leda team
Inskolning till grupparbete : ett på basen av litteraturstudier utformat inskolningsprogram jämte en empirisk undersökning av inskolningens följder
Mästerverk och mirakel : om att arbeta med tjejgrupp
Sökes : samarbetsmänniskor
Gruppen som grogrund : en arbetsmetod som utvecklar
Grupparbete som arbetsform i lågstadiet exemplifierat med en kartläggning av attityder till grupparbete som undervisningsform bland klasslärare i svenska Österbotten
Veterinärer under förändringstryck
Flow i simulatorstödd läromiljöö
Förskolan i ett könsperspektiv : att göra sig hörd och sedd
Ventana Corp. och VTKK lanserar det datorstödda mötesrummet
Gruppsykologi
Friends : övningsbok
Katedern som försvann : om lagarbete i skolan, delat ansvar och problemlösning i grupp
Grupputveckling inom skola och andra arbetsplatser
Socialt arbete med grupper : den medlande modellen
Arbetsmotivationen i teamarbete och i individuellt arbete : en studie om förändringen från individ-baserat arbete till teamarbete : case: Finnair Call Center
Se samhället ur de svagas synvinkel
Vi arbetar tillsammans : grupparbete med biblioteksövningar
Teambuilding : att utveckla arbetslag
Att utveckla ett framgångsrikt teamarbete : en praktisk handledning i interaktiv gruppdynamik
Betydelsen av personliga kontakter i ekonomers arbetssökning : en studie om skillnader mellan kön och språkgrupper
Projekt i praktiken : elevbok i projektarbete för gymnasieskolan
Pedagogik i arbetslivet : handledning för utbildare och utvecklare
Vuxna lär : förutsättningar och metoder i vuxenundervisningen : vuxenpedagogiska seminariet vid Stockholms universitet under ledning av Torsten Húsen
Skilda världar : en språkvetenskaplig undersökning av gruppsamtal som undervisnings- och lärandeform inom högre utbildning
Sokratiska samtal i undervisningen
Från idé till premiär
Effektiva arbetsteam : synliggörande pedagogik i teambuilding och personlig utveckling
Projektledning : och barsk verklighet
Sociala gestaltningar inom arbetslivet
Ett möte mellan olika forskningsprocesser : deltagardriven forskning i ett multidisciplinärt projekt
Tjejgrupper : hur de kan göras bättre? : metoder för att utveckla kvaliteten
Kläcker flera hjärnor bättre idéer? Om gymnasisternas attityder till grupp- och pararbete i svenskundervisningen
Att genomföra en förändring : introduktion av "den yrkesövergripande" arbetsmetoden inom serviceenheten Ladusved-Nöykis
Få grupper fungerar bra innan resultat förväntas
Nyckeln till teamlärande
Social kompetens : lyhördhet, självreflektion
Kreativitetens kännetecken : en fenomenologisk studie
Coaching och handledning av grupper : inom universitets- och högskoleutbildning
Teamutveckling
Åldersblandade barngrupper
Vi är ju alla här för att sjunga bättre och utvecklas : en intervjustudie om upplevelser av gruppundervisning i pop/jazz-sång
