http://www.yso.fi/onto/yso/p4081 teamarbete
teamarbete teamarbete lagarbete teamwork teamjobb
Projektledning & projektkompetens : perspektiv på konkurrenskraft
Lärande i teamorganiserad produktion : en studie av tre industriföretag
Projektsamarbete : metodbok för effektiva projekt
Skapa ett bra team! : hur du väljer rätt personer att samarbeta med
Babels torn : om tvärprofessionellt teamsamarbete
Teambaserat entreprenörskap : det sociala nätverkets betydelse för entreprenöriella team
Kreativa metoder för grupputveckling och handledning
Ledarskap inom vård och omsorg
Teamet : utveckling, effektivitet och förändring i grupper
Nya perspektiv på organisation och ledarskap
Dynamik i arbetsgrupper : om grupprocesser på arbetet
Teamwork! : utveckla ledarskap och samverkan som gör gruppen framgångsrik
Kollektiv kompetens : en studie av skicklig interaktiv handling
Chef och ledare : en bok om arbete
Det goda teamet : om teamarbete, arbetsklimat och samarbetshälsa
Studera smart när du läser till sjuksköterska
Världens bästa lag : om gruppdynamik inom idrotten
Management teams : så skapas framgångsrika team
Snövit och teamet : hur utveckla arbetslaget
Arbetsgrupper : från gränslösa team till slutna rum
Relationer i multidisciplinära designteam : om förekomsten av konflikter orsakade av skillnader i utbildningsbakgrund
Styrkebaserad teamutveckling : en praktisk handbok i Appreciative inquiry : Hur kan vi använda värdeskapande frågor och locka fram det bästa i dig, i andra och i varje situation?
Uppkomsten av entreprenöriella team : en fallstudie
Reteaming : att lyckas tillsammans : utvecklingsprogram för arbetsgrupper
Projektledarrollen i praktiken : några grunder i att leda och delta i projekt
Nya Att leda team : hur man engagerar och inspirerar team
För bättre samm[a]nhållning - case active edge
Att arbeta i par inom äldreomsorgen : aktionsforskning om socialhandledare och socialarbetare, perspektiv inom närståendevården
Systemiskt ledarskap och organisationsarbete
Förändringar av arbetsuppgifter vid införande av team : fallstudie vid Talk Family -produktionen
Ökad patientsäkerhet genom självhävdelse : En systematisk litteraturstudie
Förutsättningar för ett fungerande multiprofessionellt samarbete inom hälsovården  : En systematisk litteraturstudie
Individer, grupper och ledarskap i projekt
Utveckla teamet : en bok om gruppers utveckling
Nya effektiva arbetsteam : synliggörande pedagogik i teambuilding och personlig utveckling
Teamarbete vid trafikolycka : Utveckling och produktion av ett utbildningsmaterial
Personligt ledarskap : hur du utvecklar ledaren inom dig
Samarbetsboken
Ledaren, individen, gruppen : så skapar du effektiva team
Barnomsorgsplan och kommunalplan för småbarnsfostran : en kvantitativ studie av dagvårdspersonalens uppfattningar om dagvård och eftermiddagsverksamhet i Korsnäs kommun
Arbete i lag och grupp : om grupparbete, tema, projekt, lärarlag och lokala arbetsplaner i skola och undervisning
Medarbetarskap : från ord till handling!
Finländskt ledarskap i mångkulturella team : anpassas ledarstilen till den kulturella mångfalden?
Att effektivera projektarbete : Utvecklingsförslag för Ålands Sjödagars projektgrupp 2014
Projekt & företagande
Arbete i lärarlag : en kvalitativ studie av lärares uppfattningar och erfarenheter
Nya team i organisationernas värld
Från samverkan till integration : arena för gömda motsägelser och förgivet tagna sanningar : en studie av hur förskollärare, fritidspedagoger och lärare formar en samverkan
Styrning av team och processer : teoretiska perspektiv och fallstudier
Psykologi i organisation och ledning
Att coacha grupper : fokusera på gruppens positiva krafter / Carina Lätt ; [illustrationer: Ranelid reklambyrå]
Ledarskap och organisation i en föränderlig värld
Organisering och ledning
Studera smart när du läser företagsekonomi
Effektiv interaktion mellan ett team och dess omgivning
Palliativ vård : ur ett tvärprofessionellt perspektiv
Genom sig själv känner man inte andra : om kommunikation och teambyggande
Arbeta i grupp : om konsten att skapa ett bra team
Teampusslet : En handfast vägledning i teamarbete inom vård och omsorg
Teamarbetets effekt på anställdas work-life balans : en fallstudie om övergången från individbaserat arbete till teamarbete i Oy Igglo Ab
Teambelöningens utmaningar : fallstudie i ett parallellt team och ett arbetsteam
Bilda och leda team
Revidering av arbetssättet i det pediatriska utredningsteamet vid Ålands hälso- och sjukvård
Slutrapport projekt Entro - verksamhetskoncept för företagsamhet
Juha Siltala : arbete tar mer än det ger
Att använda arbetsgrupper effektivt : verktyg för utveckling av lag
Bästa kända arbetssätt : lyckas med standardisering genom teamarbete, kompetensutveckling och ledarskap
Politiker i norr har prövat teamarbete : kan team ersätta nämnder?
GruppExpo : En effektiv och involverande arbetsmetod - för att i stora och små grupper förädla sakkunskap och utveckla iděr, insikter och förbindning
Praktiskt ledarskap : en bok om hur man gör när man leder människor
Kommunikation och konflikthantering : en introduktion
Hur RAI stöder den rehabiliterande vården i det multiprofessionella arbetet.
Organisation och ledarskap : 1+1=3 om organisationen och dess människor
Team som en integrerad del av företaget : fallstudie Ensto Sekko Oy.
Kunskapsspridning : vägen till ett effektivt teamarbete inom bankbranschen
Omvårdnad på avancerad nivå : kärnkompetenser inom sjuksköterskans specialistområden
Att skapa effektiva team : en handledning för ledare och medlemmar
Utveckling av team i ett IT-företag : pingisens roll i teamdynamiken
Grupphandledning : forskning och erfarenheter från olika verksamhetsområden
Att utveckla ett framgångsrikt teamarbete : en praktisk handledning i interaktiv gruppdynamik
Organisationsteori : struktur, kultur, processer
Projekt i praktiken : elevbok i projektarbete för gymnasieskolan
Teamorienterade entreprenörer : en studie av samarbete och utveckling i entreprenöriella team
Individ Orienterat Ledarskap : motiverade och framgångsrika team
Socialarbetarens expertis i det multiprofessionella teamet : en studie i socialt arbete på A-kliniker
Mångkulturella virtuella team : en kvalitativ undersökning av utmaningar med att arbeta och att leda på distans
Från idé till premiär
Att lyckas tillsammans : handbok för reteaming
Effektiva arbetsteam : synliggörande pedagogik i teambuilding och personlig utveckling
Ensam eller tillsammans? : en kvalitativ studie av lärares yrkesroller och teamarbete vid integrering
Team i vård, behandling och omsorg : erfarenheter och reflektioner
Tränare Sakari Pietilä: Varje roll i laget och teamet bör uppskattas
Ledarens betydelse i teamarbetet : en studie inom företag verksamma i social- och hälsovårdsbranschen
Sammandrag.
Teamarbete inom hemvården i Kimitoöns kommun, Kimito distrikt
Rehabilitering i hemmiljö i Mariehamn : Hemrehabilitering sett ur de involverade yrkesgruppernas perspektiv
: Segellära för alla intresserade : Segelfartygsstiftelsen i Finland 40 år
Teamorienterat entreprenörskap: utveckling genom meningsskapande samarbete
Grupputveckling! : ganska invecklat
Nyckeln till teamlärande
Teamutveckling
Vi som blev kvar efter omorganisation och uppsägningar
Effektiva arbetsgrupper
Expedition Arcada : En resa för livet
