http://www.yso.fi/onto/yso/p4634 kulturpsykologi
kulturpsykologi kulturpsykologi
Sammanfattning (s. 244-249).
Sociala störningar av självet : om den narcissistiska karaktärsstörningens utbredning
Att förstå flyktingar, invandrare och deras barn - en psykologisk modell
Människan och tiden = Time and humanity
Hur är samhället möjligt? - och andra essäer
Bakom kulisserna : [en socialpsykologisk studie av en idrottsförening]
Revolutionens mentalitet : samhälle och tänkande under franska revolutionen
Tid, rum, individ och kollektiv
Den musiska människan : barnet, sången och lekfullheten genom livets faser
Inför döden
Kafékultur, kommunikation och gränser
Färger i vardagsliv och terapi : en bok om färgernas stimulerande effekt
Oro : en resa i det moderna självet
Berättelsen i sjukdomens värld : att leva med hiv/aids som anhörig i Sverige och Grekland
Könshierarkier i gungning : kvinnor i kunskapsföretag
Den musiska människan
Mellan orden : kommunikation i praktiken
Kravatten som lust och last : slipsens historia och psykologi
Rötter och fötter : identitet i en ombytlig tid
Känslan för platser : en jämförande utvecklingspsykologisk studie av barns och ungdomars värdering av fysisk miljö i Sverige och Frankrike. D. 1, Landsbygdsbarn
Talangfabriken : en inspirationsbok om den moderna arbetsplatsen
Ideal och verklighet : Hilma Granqvists studier av "Kvinnorna i Gamla testamentet" åren 1921-1925
Stereotyper, kognition och kultur
Ungdomsvåld : orsaker och åtgärder
Om hälsningsceremonier, mikromakt och asocial pratsamhet
Svensk mentalitet : ett jämförande perspektiv
Förförd av Eros : kön och moral bland utländska kvinnor bosatta på en grekisk ö
Nyheter mitt ibland oss : kommunala nyheter, personlig erfarenhet och lokal opinionsbildning
Att lyckas som förändringsledare : processmetodikens grunder
Kläder som språk och handling : om unga kvinnors användning av klädseln som kommunikations- och identitetsskapande medel
Kreativitet inom forskning, kultur och näringsliv : 21 dialoger
Perspektiv på sociala problem
Kommunikation : samspel mellan människor
"Hålla ordning, men inte överordning" : köns- och maktperspektiv på uppförandenormer i svenska klassrumskulturer
Ett oskrivet blad : och andra myter om människans natur
Tonårsnormer i förändring? : en empirisk studie av 15-åringar i en mellanstor svensk stad 1969 och 1995
Kön och identitet i förändring
Att möta flyktingar
Kroppen ljuger aldrig : konsten att tala kroppspråk
Arbetsglädje : att skapa större arbetslust
Genus och kultur i psykologi : teorier och tillämpningar
Platser för en bättre värld : Auschwitz, Ruhr och röda stugor
Ny ungdom : om ovanliga läroprocesser
Gränser och gränsöverskridanden : skildrade erfarenheter av kulturella möten i internationellt projektarbete
Ut ur Kalahari : drömmen om det goda livet
Förhörsgrammatik : samtalsteknik för att söka sanningen
Att ha rätt : om övertygelse, tolerans och fundamentalism
Humorologi : vetenskapliga perspektiv på humor och skratt
Fostran till lönearbete
Om könens uppkomst : hur kroppen blev kvinnlig och manlig
Alla dessa kulturer : allmän kulturell förståelse
Kulturens förnyelse
Krig och kultur :/ : socialpsykologiska dokumenter och iaktagelser från världskriget 1914
Nytt land och ny skola : berättelser om att bryta upp och börja om
Mat på hjärnan : om ätandets psykologi
Att använda arbetsgrupper effektivt : verktyg för utveckling av lag
Mardrömmar och önskedrömmar : om ungdom och ungdomlighet i nittiotalets Sverige
Lärande i praktiken : ett sociokulturellt perspektiv
Modernitet, adolescens & kulturella uttryck
Kulturens väv : utbildning i kulturpsykologisk belysning
Textbilagans innehåll: Lektionsförslag för år 6-9, gymnasiet.
Rummet som plats : en jämförande utvecklingspsykologisk studie av barns och ungdomars värdering av fysisk miljö i Sverige och Frankrike. D. 2, Stadsbarn
Arkitekturen som brukskonst : Husens språk revisited
Tio tankar om skolan : brev till Storm
Utanför : avvikandets sociologi
Management by glädje
Om unga kvinnor : identitet, kultur och livsvillkor
Från prat till resultat : om vardagens ledarskap
Njutandets förvandlingar : sex essäer om kvinnan, kulturen och makten
Sociokulturella ramar för barns utveckling : barns livsvärldar
De laglösa : rättens betydelse för levnadsförhållandena i en kriminell subkultur
Hotbilder : våld, aggression och religion
Moderna människor : antropologiska perspektiv på samtiden
Människans symboliska verklighetsbygge : en psykofenomenologisk studie
Musikliv : vad människor gör med musik - och musik med människor
By og borger i middelalderen : ett försök i kulturpsykologi
Klassens tysta språk : [att förstå det som ingen säger]
Mord, misshandel och sexuella övergrepp : historiska och kulturella perspektiv på kön och våld
Skammens röda blomma? : menstruationen och den menstruerande kvinnan i svensk tradition
