http://www.yso.fi/onto/yso/p7481 samarbetsinlärning
samarbetsinlärning samarbetsinlärning kooperativt lärande
Vuxnas lärande på nätet : betingelser för distansstudier och interaktivt lärande ur ett studentperspektiv
Perspektiv på ökad tillgänglighet inom högre utbildning : med hjälp av digitala verktyg
Emancipation och motstånd : dokumentation och kooperativa läroprocesser i förskolan
Engagerade elever - en samverkande skola : handboken för elevkårens handledande lärare
Broar till lärande : mot engagerande inlärningsmiljöer
Dramalek för att utveckla barns interaktions- och samarbetsfärdigheter : "Det var en gång ..." - ett stödmaterial föör dramalek
Många sätt att stöda : samarbetsformer för utveckling av livskompetens hos elever i grundskolans högre årskurser
Pedagogikens tango : om individen, gruppen, tänkande och lärande
Barns samlärande : en forskningsöversikt
Effektiv inlärning
"Ingen kan allt, men alla kan något" : en kvalitativ studie av lärares uppfattningar av samarbetsinlärning
Barn lär av varandra : samlärande i förskola och skola
Att lära sig muntlig kommunikation genom smågruppsarbete : ett materialpaket för svenska som B1-språk för årskurs 6
Fortbildning i miljöpedagogik : ett projektförsök baserat på KOVA-modellen
Att lära i samarbete : grupparbete i förskola och skola
Samarbetsinlärning i heterogena klasser
Samarbetsinlärning
Att lära i samarbete : samarbetsinlärning i teori och praktik
När barn lär av varandra : samlärande i praktiken
En ny lärandekultur : att odla fantasin för en ständigt föränderlig värld
"Det är som fyra, fyra och tre, tre, tre." : en kvalitativ studie av små gruppers diskussioner och samarbete vid lösandet av ett matematiskt problem i tre olika länder i årskurs 6
Team work : medel för morgondagens skola?
Samarbetsinlärning i huslig ekonomi : en undersökning om pusselmetoden som arbetsmetod i huslig ekonomi
En för alla : en studie i kooperativ inlärning
"En för alla - alla för en" : en undersökning om samarbetsinlärning i högstadiets religionsundervisning
På väg mot en samarbetande skola : förändring genom samarbetsinlärning
Vilse i skolan : hur vi kan hjälpa barn med beteendeproblem att hitta rätt
Nära samarbete - på distans : nio texter om att lära på nätet
Lärande samtal : elevers kollektiva textbygge i samband med diktskrivande
Sociala handlingar och deras inneborder: lärande och identitet
Lärande i en traditionstung kontext : om psykoanalytiker som lär gemensamt i samband med utvecklandet av en metod för behandling av spädbarn och föräldrar
