http://www.yso.fi/onto/yso/p7585 kvinnokultur
kvinnokultur kvinnokultur
Fruar och mamseller : kvinnor inom sydsvensk borgerlighet 1790-1870
Den nya kvinnostaden : pionjärer och glömda kvinnor under tvåtusen år
Kvinnor, män och andra sorter : genusantropologiska frågor
Kvinno- och mansrepresentationer i universitetens reklamer
Kvinnor i väglöst land : nybyggarkvinnors liv och arbete
När Ålands kvinnor fick sångröst
Sociala konflikter och kulturella processer : historia med människor i centrum
Pyssel, omsorg och uppoffring : hästflickor på väg mot omsorgsfällan?
Könshierarkier i gungning : kvinnor i kunskapsföretag
Som hon drack : kvinnor, alkohol och frigörelse
Astra : samhälle, kultur, feminism
Sophie Creutz och hennes tid : adelsliv i 1700-talets Finland
Amningspraktikens villkor : en intervjustudie av en grupp kvinnors föreställningar om förväntingar på och erfarenheter av amning
Kvinnan : hennes ställning och inflytande i det gamla Grekland och Rom samt under kristendomens första århundraden
Harem : världen bakom slöjan
Begynnelser : litteraturforskningens pionjärkvinnor 1850-1930
Sekelskiften och kön : strukturella och kulturella övergångar år 1800, 1900 och 2000
Catrines intressanta blekhet : unga kvinnors möten med de nya kärlekskraven 1750-1830
Genom symaskinens nålsöga : teknik och social förändring i kvinnokultur och manskultur
Var fanns kvinnoenergin? : ett besök på fåfängans marknad - "Kvinnor som kan" mässan
Skärgårdskvinnor : tradition, modernitet och diversitet
Ideal och verklighet : Hilma Granqvists studier av "Kvinnorna i Gamla testamentet" åren 1921-1925
Receptbok
På besök hos kronprinsessan i Malaysia
Förförd av Eros : kön och moral bland utländska kvinnor bosatta på en grekisk ö
Kvinnor på gränsen till genombrott : grupporträtt av Tidevarvets kvinnor
Kvinnor och våld : en mångtydig kulturhistoria
Häxor och helgon : en bok om årets högtider
Behagets betydelser : döttrarnas edukation i det sena 1700-talets adelskultur
Gudomliga uppenbarelser och demoniska samlag : en studie av det excentriska idéarvet i Cecilia Rodríguez tänkande
Kvinnoöden i vikingatid
Finska hushållningssällskapets arkiv och skrifter : en källa för forskningen. 1
Poeten och hennes apostlar : en biomytografisk analys av Edith Södergranbilden
När var tar sin
Medier, genus och makt
Kvinnor i västvärlden från renässans till nutid : renässans, reformation och revolution
Att finnas i Glappet : frigörande flickkultur i TV
Tröskelkvinnor : barnafödande som kultur
Helena Westermarck : intellektets idoga arbetare
En grym bankett : om Frida Uhl, Strindbergs andra hustru
Hvitträsk : guidebok
Feministisk motkultur och kvinnomakt : "nya" kvinnorörelser och en studie av feminismen i Västtyskland
Suomen urheiluhistoriallisen seuran vuosikirja 1995 = Finlands idrottshistoriska förenings årsbok 1995
80 år av envishet
Drottningar och sköldmör : gränsöverskridande kvinnor i medeltida myt och verklighet ca 400-1400
Stalins kossor
Effekten av musik i tv-program som intresserar kvinnor
Liksom en herdinna : litterära teman i svenska kvinnoporträtt under 1700-talet
Marie Linder : liv & litteratur
Etnologisk samhällsforskning
Journalistikens essens i ett könsperspektiv
Projekt perfekt : om utseendekultur och kroppsuppfattning
Studentföreningen Verdandis småskrifter 228 - 237.
Kön och kulturarv
Backlash : kriget mot kvinnorna
Kvinnor får röst : kön, känslor och politisk kultur i kvinnornas rösträttsrörelse
Om unga kvinnor : identitet, kultur och livsvillkor
Unga kvinnor
Är de här för att stanna nu? : teaterarvets akilleshäl
Att se och synas : filmutbud, kön och modernitet
Kulturens fält : en antologi
Dekadensens kön : Ola Hansson och Laura Marholm
Fantastiska fröknar : studier av lärarinnegestalter i svensk skönlitteratur
Sarvlax : herrgårdshistoria under 600 år
Prästgårdar, prästfruar, prästgårdsliv : en förteckning över artiklar om prästgårdar osch prästfruar i Borgå stift under åren 1923-1987
Nytänkande och eftertankar : kön, kulturella föreställningar och livsvillkor : ett urval artiklar från STRAS-projektet
Den dolda offentligheten : kvinnlighetens sfärer i 1800-talets svenska högreståndskultur
Sedens höga uppfostrarinna : kvinnlighet och kvinnoideal i tidskriften Hemmet och samhället
Nerdrumdskvinnor och skärgårdskunskaper
Astra : månadsrevyn
Industriomvandling och könsstruktur : fallstudier på fyra lokala arbetsmarknader
Hår : fint, fult, fräckt och fusk
Martha - nu : smartha tankar för ett liv i balans
Om konsten att konstruera en kvinna : retoriska strategier i 1800-talets rådgivare och i Marie Sophie Schwartz' romaner
Talet om kroppen : en antologi om kropp, idrott och kön
Pukujen takana : kurkistus luovien naisten vaatekaappiin = Bakom dräkterna : en titt i skapande kvinnors garderober
Huvudstadens hjärta : filantropi och social förändring i Helsingfors : två fruntimmersföreningar 1848-1865
