http://www.yso.fi/onto/yso/p8552 delkulturer
delkulturer delkulturer subkulturer
The football factory
Subkulturen hiphop och dess betydelse för ungdomars identitetsutveckling
Hiphop i Skandinavien
AlieNation is my nation : hiphop och unga mäns utanförskap i Det nya Sverige
Reservdelar till gamla hus : katalog. No 7, Handbok och postorder
Tatuering : ett sinnligt äventyr
Förorten, skolan och ungdomskulturen : reproduktionen av marginalitet och ungas informella lärande
Norr om Långa bron
Ungdomskulturen och de andra : sex essäer om ungdom, identitet och modernitet
Lifestylevarumärken och varumärkesstammar
Men with attitude : en sommarkollektion herrkläder
Spår : om brädsportkultur, informella lärprocesser och identitet
Ungdomskultur, stil och smak
Samtidskultur : karaoke karnevaler och kulturella koder
Vardagsvingar och klasskalas : en politisk pysselbok
Rockabilly : en bok om de sista romantikerna
Fristadens barn : om ungdomars livsstilar, kulturer och framtidsperspektiv i 80-talets Sverige
Sammanfattning (s. 45-46).
Satansdyrkan som en moralisk panik i de finska medierna på 1990-talet
Det mörka nätet : nedslag i den digitala underjorden
Hela världen är din : en bok om unga heroinister
Rock'n'roll i Hultsfred : ungdomar, festival och lokal gemenskap
Rock och uppror : amerikansk, brittisk och svensk rockkultur 1955-1969
Ungdom som samhällsproblem
Krigaren och transvestiten : gestaltningar av mörker och maskuliniteter i finländsk black metal
Nazismen i Sverige 1980-1999 : den rasistiska undergroundrörelsen: musiken, myterna, riterna
Musikrörelsen - en motoffentlighet ?
Flyktingskap : latinamerikansk exil i Sverige och Västeuropa
Wrestlarna : roman
"Ingen vill ju bli horsare, så man tänker ju då 'Ja, man kanske ska ta ett tag till'"
Musikhus i centrum : två lokala praktiker inom den svenska progressiva musikrörelsen: Uppsala Musikforum och Sprängkullen i Göteborg
Huggarna : om en bikerklubb och deras stiluttryck
Manlighet och maskulinitet i klädsel och kropp (2015)
Hells Angels
Våldsamma teorier : därför slåss killar i klubbarnas namn
Med framtiden i backspegeln : black metal- och transkulturen : ungdomar, musik och religion i en senmodern värld
Exotismer, romanticismer och vanliga överdrifter : mönster och metaforer i svensk drogslang
Bostadslös alkoholist med liten pension : överlevnad i samhällets utkant
Våld, populism och extremism i Norden : nordiska insatser mot nynazism, våldsbenägna ungdomsgäng och andra extremistiska rörelser
Ungdomskultur : identitet och motstånd
Punkare och skinheads : socialisering i gäng
I transformation : kulturen i den virtuella staden
En generation intellektuella i uppror
Sammandrag: Mot natten i Helsingfors.
Fandom - ett sätt at leva och se filmer
I denna bok rapporteras resultat från sju forskningsprojekt inom forskningsprogrammet Skolkultur - en framgångsfaktor? Forskarna kommer från olika vetenskapliga dicipliner: etnologi, företagsekonomi, pedagogik, socialantropologi, sociologi och statsvetenskap.
Avantgarn : textiler i gatukonsten
Vän av ordning
Hells Angels : en sällsam och skrämmande legend
"En punkscen där man inte super" : en diskursanalytisk studie av straight edge-scenen i Finland
Såna som oss : röster om sexualitet, identitet och annorlundaskap
Gemenskapernas tid
UG  : En studie i den finländska undergroundkulturens utveckling
Modernitet, adolescens & kulturella uttryck
"Heter det faktiskt så?" : - språkvårdsfrågor i spalten Frågor och svar i tidskriften Språkvård 1965-1995
Faktorer som påverkar ungdomars köp av kläder
Den regionala särarten
Utanför : avvikandets sociologi
Vagabond MC : gemenskap, manlighet och marginalitet : en studie av en västsvensk bikerklubb
Hjälpreda vid kulturhistorisk byggnadsinventering
Identifiering och utnyttjande av subkulturer och livsstilar i marknadsföringen
Graffitins spänningsfält : en studie av graffitikultur och intervntioner på en lokal arena
Gnägget på Stallören
Slaget om identiteten : media och motstånd bland de unga
Dansbaneeländet : ungdomen, populärkulturen och opinionen
Reservdelar till gamla hus : handbok : katalog och postorder. No 8
Planet Hiphop : om hiphop som folkbildning och social mobilisering
Ungdom och kulturens omvandlingar : åtta essäer om modernitet, ungas skapande och fascination inför svart kultur
Vägarnas folk : de resande och deras livsvärld
Intervjuer med yngre män om normer kring klädsel och manlighet. Intervjutranskriberingar och fältanteckningar.
De laglösa : rättens betydelse för levnadsförhållandena i en kriminell subkultur
En mot hundra : jag infiltrerade Hells Angels
Ungdomsgrupper i teori och praktik
Under rocken : musikens roll i tre unga band
"Samhällets bottenskikt" : om den helsingforsiska subkulturens historia
Stora boken om Nemi
Satan på Säätämö : en inblick i delkulturen blackmetal
Blatte betyder kompis : om maskulinitet och språk i en högstadieskola
Från Elvis till Emo : ungdomskulturer 1950-2010
Göteborg : kulturmiljöer av riksintresse
Blandsverige : om kulturskillnader och kulturmöten
Georgia : den nya södern - och den gamla
Respekt : gatukultur, ny etnicitet och droger
