http://www.yso.fi/onto/yso/p9266 närvaro
närvaro närvaro
Här är jag! Vem är du? : om närvaro, respekt och gränser mellan vuxna och barn
När allting faller på plats : en bok om att finna mening
Din väg till mindfulness : steg för steg i åtta veckor
En sån dag
ACT i teori och tillämpning : vägen till psykologisk flexibilitet
Vad finns att hämta i gränslandet mellan skådespelare och publik? : reflektioner kring att vara här och nu
Compassion : medkänsla med dig själv och andra : med en introduktion till Compassion Focused Therapy (CFT)
Lär dig leva : mindre stress - mer närvaro
Barns sociala samvaro : inklusion och exklusion i förskolan
Dags att må bra : bestäm dig för att skapa ett bättre liv
Mindfulnessbaserad kognitiv terapi vid depression
Närvaro och tystnad
Kunskapens gräns, gränsens vetande : en fenomenologisk undersökning av transcendens och kroppslighet
Uppföljare till Lär dig leva
KBT i utveckling : en introduktion till kognitiv beteendeterapi
På liv och död
Fri från stress med mindfulness : medveten närvaro och acceptans
Mindfulness för föräldrar
Medveten närvaro : finn ditt inre lugn med mindfulness
Tystnad : finn din inre stillhet i en värld full av brus
Sök inom dig själv : den oväntade vägen till framgång, lycka (och fred på jorden)
Lev livet fullt ut i praktiken : meditationer, övningar och principer för ett frigjort liv
Närvaro : ett drag i Helene Schjerfbecks måleri från 1902 till 1920-talet [Valokopio] / Lars Wängdahl ; handledare: Irja Bergström
Att kunna lyssna med kroppen : en studie av gestaltande förmåga inom gymnasieskolans estetiska program, inriktning teater
Vem är det som bestämmer i ditt liv? : om medveten närvaro
Andra boken om femtonåriga Susannah, kontaktperson mellan levande och döda, som nyligen flyttat till Kalifornien. Här kommer hon en vampyr på spåren då en död kvinna ber om hennes hjälp att framföra ett viktigt meddelande till traktens rikaste affärsman.
12 steg till ett liv i medkänsla
En liten guide in i i barnyogans värld : yoga och mindfullness för barn och ungdomar
I svarandens frånvaro : förenklade brottmålsrättegångar i tingsrätten
Simple living : nya vägar till ett meningsfullt liv
Linn Ullmann och hennes far Ingmar Bergman hade ett gemensamt projekt. De skulle skriva en bok tillsammans, baserad på bandinspelningar av samtal mellan dem. Men efter det sjätte samtalet blev Bergman så dålig att projektet fick avslutas. En tid efter Bergmans död hittar Ullmann bandinspelningarna och slutför boken. Det blir en berättelse om familj, glömska och sorgearbete, och om de många historier som utgör ett liv.
De oroliga : roman
Närvarande föräldrar betyder trygghet
Sov : 50 mindfulness- och avslappningsövningar för en god natts sömn
Kroppen ljuger aldrig : konsten att tala kroppspråk
Längtan efter barn : en kvalitativ studie om barnlösa pars upplevelser av infertilitetsutredning, - behandling och bemötande från personalen
Nedstressad förskola : medveten närvaro
Vart du än går är du där : medveten närvaro i vardagen
Bli fri från din rädsla med hjälp av mindfulness
Mindfulness i skolan : om hälsa och lärande bland barn och unga
Fokus på jobbet : träna din hjärna med mindfulness för mer fokus, effektivitet och glädje
Mindfulness i socialt arbete : en introduktion
Lär dig leva : mer stress - mer närvaro
Den harmoniska kroppen : en osynlig övning
Övning ger färdighet
Lilla boken om kärlek
Empati : närvaro eller metod
Virka dig lugn : 20 projekt för avkoppling och mindfulness
Sitta stilla som en groda : mindfulness för barn 5-12 år (och deras föräldrar)
Att ta sig upp när man är nere : självhjälp vid depressioner
Hjärnstorm : överlev tonårstiden med forskningens hjälp
Mindfulness : medveten närvaro som levnadsstrategi
Insikt och närvaro : akademiska kontemplationer kring buddhism, meditation och mindfulness
Ett tryggt barn : - en investering för framtiden: att skapa ett redskap som kan stödja barnfamiljerna i deras trygghetsfostran
Mindfulness för ledare : nio steg till autentiskt ledarskap
Mindfulness i hjärnan
Diskussioner om närvaro
Lugn : 50 mindfulness- och avslappningsövningar för att komma ner i varv : [visuella hjälpmedel för mindfulness]
Mindfulness : en väg ur nedstämdhet
Mindfulness : steg för steg
Lev livet fullt ut : din väg till andligt uppvaknande
Lilla boken om mindfulness : [närvaro, fokus, balans]
Fäders betydelse för barns och ungdomars hälsa : en systematisk översikt av longitudinella studier
Under våra fötter formas stigen
Konsten att lyssna : enkelt och djupt
Lyckofällan
Att möta den andra : det pedagogiska uppdraget i ljuset av Martin Bubers dialogfilosofi
En resa i mindfulness : bli fri från stress och oro genom att leva i nuet
Närvaro som mellanmänskligt varande och grund för det caritativa vårdledarskapet
Identitet : funderingar kring ”jaget” och tillförlitlighet  på scen
Silvertråden som brast
Mindfulness i praktiken : [en steg-för-steg-guide]
Mindfulnessbaserad självhjälp : en övningsbok vid depression, oro och ångest
Konsten att sova : [sömnexpertens bästa råd och strategier]
Heartfulness : din väg till glädje i nuet
Leva i nuet : positiv mindfulness meditation
Må bra i förskolan : [musik, yoga, lek, miljö, mindfulness, massage]
Mindful eating : ät bra, må bra, gå ner i vikt med mindfulness, compassion och KBT
Medlaren
Dödlig hämnd
