http://www.yso.fi/onto/yso/p9734 mind and body
mind and body mind and body kropp och själ
Din inre energi
Leva i sin kropp : kroppsuttryck och mänsklig kontakt
Fri från stress med mindfulness : medveten närvaro och acceptans
Den harmoniska kroppen : en osynlig övning
Kroppen ljuger inte : vägen till självkännedom och självläkning
Lär med hela kroppen : inlärning sker inte bara i huvudet
Psykosomatik : kroppens och själens dialog
Sund självkärlek
" De senaste decennierna har det skett betydande framsteg i förståelsen av psykosomatiska sjukdomar, inte minst i samspelet mellan psykologi, neurovetenskap, immunologi och endokrinologi. Denna bok ger dig en uppdatering av de olika koncept som dominerar forskningen samt en ökad förståelse för hur psyko-somatiska tillstånd kan uppstå, diagnosticeras och behandlas. Psykosomatik i teori och praktik behandlar psykosomatik i förhållande till intersektionalitet, migration, arbetsmiljö och ett livscykelperspektiv. Därtill kommer flertalet kapitel med organspecifikt fokus, samt avsnitt om stress, smärta och sömn. Boken avslutas med mer behandlingsinriktade kapitel om mindfulness, naturterapi, konstnärliga terapier och integrativ medicin. Flertalet fall-beskrivningar är hämtade ur den kliniska vardagen och sätter in de psykosomatiska processerna i sitt medicinska sammanhang. Boken ger dig som student på utbildningen till läkare, sjuksköterska, barnmorska, psykolog, socionom, sjukgymnast eller arbetsterapeut ett handfast material att använda inför och efter patientmöten. Den ämnar sig även för den yrkesverksamma som vill få stöd och inspiration i det kliniska arbetet. " -- (Studentlitteratur)
Psykosomatik : om kropp, själ och meningsskapande
Vaken vila : en väg till avslappnad närvaro
Njut av livet och må bättre : [ät rätt, stressa av, kloka råd för kropp och själ]
Hudjaget : om hudens psykiska betydelse
Den helige Antonios : en undersökning i kroppsteologin hos Athanasius i hans bok Antonios liv
Hälsans hemligheter : så lever du ett långt liv och friskt liv
Författaren skriver om vad som finns bakom kroppens signaler och de underliggande mentala, emotionella och energimässiga orsakerna till fysiska symptom och medicinska problem. Med hjälp av en steg för steg-metod ska kroppen ges möjlighet att hitta tillbaka till sin naturliga hälsa
Kroppens hemliga språk : en nödvändig vägledning för hälsa och friskvård
Själ och kropp : rörelse för psykiskt välbefinnande
Förlåtelsens etik i ett vårdteologiskt meningssammanhang
Kroppskänning : att vara en kropp med själ
Vacker i Guds ögon : kroppslig teologi för flickor och pojkar
Darwins ofullständiga idé : om missförståndet mellan oss och naturen
Skapa dig själv på nytt : återupptäck kroppen och låt själen återuppstå
Drömmarnas helande kraft
Psykosomatik i teori och praktik
Kroppens ord och kristendomens ord
Let go! : bli fri från ditt kontrollbehov
Perfekt hälsa : det helande sambandet mellan kropp och själ
Hitta hem till dig själv
Medvetandets filosofi : en översikt av moderna filosofiska teorier om förhållandet mellan medvetande och materia
