http://www.yso.fi/onto/yso/p9885 nätstudier
nätstudier nätstudier webbstudier nätbaserade studier onlinestudier
Vuxnas lärande på nätet : betingelser för distansstudier och interaktivt lärande ur ett studentperspektiv
Att förstå lärgemenskaper och mötesplatser på nätet
Lärgemenskaper på nätet : en introduktion
Nätkurserna moderniseras : informationsförvaltning videofilmar sina föreläsningar för nätbruk
Gå på kurs - på nätet!
Svenskstudier på nätet : en undersökning av den virtuella inlärningsmiljön i svenskundervisningen i distansgymnasiet
Kvalitetskriterier för nätbaserade läromedel : arbetsgruppsrapport 16.12.2005
Affärssvenska på nätet : att skapa en kurs i svenska för blivande tradenomer och restonomer
Kunskapa på nätet - med hjälp av lärobjekt : handbok för lärare, utbildare och dig som skapar lärobjekt
E-learning och arbetsplatslärande : en revolution av vuxenutbildningen?
Juridiken kring e-lärande
Kunskapsbygge på nätet : en studie av studenter i dialog
Lärande i webbkonferenser : vad säger studerande som läser svenska på distans?
Med hög kvalitet på nätet : handbok i nätbaserad undervisning för universitetslärare
Studieteknik för effektiva studier
Fotboll är världens språk och vägen till språkinlärning!
Producenten, regissören och aktören
Virtuellt lärande på distans : en intervjustudie med finländska gymnasiestuderande
E-uttalsinlärning : en kvalitativ innehållsanalys av svenska och engelska uttalswebbplatser som inlärningsmaterial för självstudium
Utvecklandet och befästandet av den nätbaserade undervisningen inom gymnasieutbildningen, den grundläggande yrkesutbilningen och vuxenutbildningen samt det fria bildningsarbetet : arbetsgruppsrapport 21.4.2005
E-learning och flexibelt lärande : en undersökning av Arcada-studenternas erfarenheter och behov
Premiär för virtuella inlärningsmiljöer : allmän teologi & ekonomisk geografi
Nätkurser korsar gränser
Webbaserade distansstudier : ett beaktansvärt alternativ?
E-Learning : Practices, lessons learned and the way forward = E-lärande: Erfarenheter, lärdomar och vägen vidare
Nära samarbete - på distans : nio texter om att lära på nätet
Dags att studera svenska i internetix? Skillnader mellan gymnasiekurser i svenska på nätet och i en lärobok
Lärande för alla sinnen : handbok om eLearning - pedagogik och integrering
Nätbaserade distans- och flerformsstudier i gymnasiet : en deskriptiv undersökning om hur heltidsstuderande vid ett vuxengymnasium uppfattar distansundervisning
Potentialen och rösterna i nätbaserade dialoger : dialogiska och medierande redskap för lärande
Lärande och handledning på nätet : resultat av AiHe-projektet 2006
Utbilda via Internet : handbok i IT-pedagogik. 1
Nätbaserad utbildning - en introduktion
Lärande i samspel : med eTwinning som språngbräda
Nätpedagogiska toppar och floppar : erfarenheter av Pil-projektet
Lär där du är : handbok och webbplats för distansstuderande och andra som lär på nätet
